,symbol,timestamp,close,high,low,open,volume,change_in_price,down_days,up_days,RSI,low_14,high_14,k_percent,r_percent,MACD,MACD_EMA,Price_Rate_Of_Change,On Balance Volume,Prediction
14,ABBV,2020-03-23,52.26048278808594,54.89376292857089,50.68051408563087,54.59397188718647,19219000.0,-3.5002288818359375,3.5002288818359375,0.0,18.560113614640045,50.68051408563087,74.42864257539432,6.653024060974359,-93.34697593902564,-2.3594263398441484,-1.4419259554897732,-0.263109790830502,-103210600.0,-1.0
15,ABBV,2020-03-24,54.68309020996094,58.19143053047483,54.35899300717379,55.2259556518264,18376300.0,2.422607421875,0.0,2.422607421875,29.42115503402738,50.68051408563087,74.30711055272133,16.94097636917474,-83.05902363082525,-2.46002062488855,-1.651442248746009,-0.2045964449651877,-84834300.0,1.0
16,ABBV,2020-03-25,55.023399353027344,57.26776135094943,53.11123252849195,55.03149730194966,20017300.0,0.34030914306640625,0.0,0.34030914306640625,30.914498500138734,50.68051408563087,72.72713498971957,19.698643553085525,-80.30135644691447,-2.4851492554604704,-1.8220248282974194,-0.13611498395883415,-64817000.0,1.0
17,ABBV,2020-03-26,59.82001495361328,60.20892665464184,55.71209879436392,55.76071121158248,15979400.0,4.7966156005859375,0.0,4.7966156005859375,48.60121508075997,50.68051408563087,71.47937858979446,43.942306880035844,-56.057693119964156,-2.171459537881951,-1.8931938371004284,-0.1351763541255918,-48837600.0,1.0
18,ABBV,2020-03-27,58.88014221191406,60.816615412611405,57.292072475615534,58.03749182867875,12293300.0,-0.9398727416992188,0.9398727416992188,0.0,45.94200706199736,50.68051408563087,71.47937858979446,39.42344123950498,-60.576558760495026,-1.9642658105634254,-1.9076160781917633,-0.02154306241630699,-61130900.0,-1.0
19,ABBV,2020-03-30,60.962459564208984,61.77269961331941,59.52833739720557,59.56884569067649,10671600.0,2.082317352294922,0.0,2.082317352294922,52.57538536179037,50.68051408563087,70.19919357164298,52.677464609973136,-47.322535390026864,-1.6451340129489438,-1.8545073633489564,0.03040276054272595,-50459300.0,1.0
20,ABBV,2020-03-31,61.7321891784668,63.13390095308594,60.314269141708714,61.09209882007625,20474400.0,0.7697296142578125,0.0,0.7697296142578125,54.9340312520634,50.68051408563087,69.93991440754338,57.38327729893962,-42.616722701060375,-1.3279217020233105,-1.7482098091952598,0.0726456622131082,-29984900.0,1.0
21,ABBV,2020-04-01,59.487823486328125,59.949660071435886,57.875447504164676,58.434515121478675,12948000.0,-2.244365692138672,2.244365692138672,0.0,47.05973510925161,50.68051408563087,69.93991440754338,45.72992540518865,-54.27007459481135,-1.2170535774546494,-1.6411888878283425,0.03321157799817276,-42932900.0,-1.0
22,ABBV,2020-04-02,60.87332534790039,61.173116355430075,57.899746208653944,58.9692626976687,8077800.0,1.3855018615722656,0.0,1.3855018615722656,51.96425196003658,50.68051408563087,66.58553102746194,64.08551024841644,-35.91448975158356,-1.0225135622346855,-1.5167190826645678,0.09168845814312543,-34855100.0,1.0
23,ABBV,2020-04-03,59.447303771972656,61.124500120065186,58.78290730030412,60.48440985636844,8062700.0,-1.4260215759277344,1.4260215759277344,0.0,46.81374054053042,50.68051408563087,63.13390095308594,70.3968308352516,-29.603169164748387,-0.9573842533334798,-1.404321333434637,0.13751922294765206,-42917800.0,-1.0
24,ABBV,2020-04-06,61.35948944091797,62.59915588461804,59.98207747330762,61.36758739165721,10266500.0,1.9121856689453125,0.0,1.9121856689453125,53.88560684557423,50.68051408563087,63.13390095308594,85.7515748040791,-14.248425195920897,-0.762572577090161,-1.2754848516992474,0.12209257387105144,-32651300.0,1.0
25,ABBV,2020-04-07,61.083988189697266,63.66865555981957,60.970555093357106,63.5066038638764,11591700.0,-0.2755012512207031,0.2755012512207031,0.0,52.720264317017154,50.68051408563087,63.66865555981957,80.09979044916622,-19.900209550833786,-0.6213295374150789,-1.1442571775335464,0.11014566362549671,-44243000.0,-1.0
26,ABBV,2020-04-08,63.652435302734375,63.99274070925708,60.58972991550274,61.934730920956056,12218500.0,2.5684471130371094,0.0,2.5684471130371094,61.64337305409265,50.68051408563087,63.99274070925708,97.44366276097841,-2.556337239021584,-0.32196405934796957,-0.9793999535872737,0.06406585408066001,-32024500.0,1.0
27,ABBV,2020-04-09,64.61663818359375,64.8840188596713,63.652450632572545,63.652450632572545,9425900.0,0.964202880859375,0.0,0.964202880859375,64.54205404819287,50.68051408563087,64.8840188596713,98.11750212126348,-1.8824978787365134,-0.015842140622652323,-0.7863149102034244,0.09742666637987396,-22598600.0,1.0
28,ABBV,2020-04-13,65.06227111816406,65.89681728607388,63.73347808120546,65.35395799765647,9293500.0,0.4456329345703125,0.0,0.4456329345703125,65.91568888698274,53.11123252849195,65.89681728607388,93.47275714225796,-6.527242857742034,0.25531257236672644,-0.5776665459841462,0.06725141313625871,-13305100.0,1.0
29,ABBV,2020-04-14,67.53746795654297,68.12954224119035,66.02439480585231,66.29576323195474,11072700.0,2.4751968383789062,0.0,2.4751968383789062,72.6949338213799,53.11123252849195,68.12954224119035,96.0576503216819,-3.9423496783181013,0.6438031476009556,-0.33306981117562806,0.09403973608149885,-2232400.0,1.0
30,ABBV,2020-04-15,67.28254699707031,68.28578324462109,65.4734367719956,66.20530460363497,8977300.0,-0.25492095947265625,0.25492095947265625,0.0,71.01640350900189,55.71209879436392,68.28578324462109,92.02114343238306,-7.978856567616939,0.9211223878428285,-0.08198270674800148,0.13103057153425057,-11209700.0,-1.0
31,ABBV,2020-04-16,67.31542205810547,68.84494472095183,67.08517241403523,68.03084597260853,10326900.0,0.03287506103515625,0.0,0.03287506103515625,71.11564576669687,57.292072475615534,68.84494472095183,86.7606718886396,-13.239328111360393,1.129568515164351,0.16051966780988464,0.10582790858536972,-882800.0,1.0
32,ABBV,2020-04-17,68.62294006347656,69.7248575625133,67.84173471867418,69.07522080446824,10734800.0,1.3075180053710938,0.0,1.3075180053710938,75.03804639261242,57.875447504164676,69.7248575625133,90.70065519202483,-9.299344807975176,1.376267423659172,0.4038234310605032,0.1543490740421083,9852000.0,1.0
33,ABBV,2020-04-20,69.06698608398438,70.16890342789338,67.94862502173365,68.69694281987465,9126300.0,0.4440460205078125,0.0,0.4440460205078125,76.29923451243407,57.875447504164676,70.16890342789338,91.03655350663358,-8.963446493366428,1.5863334737344985,0.6404454211984324,0.12561213780124136,18978300.0,1.0
34,ABBV,2020-04-21,66.08195495605469,68.22822102696746,65.80236154290925,67.84995275233989,9627500.0,-2.9850311279296875,2.9850311279296875,0.0,54.8167903670151,57.875447504164676,70.16890342789338,66.75508907181984,-33.244910928180154,1.5089191951969383,0.8142106635545404,0.0818212254058488,9350800.0,-1.0
35,ABBV,2020-04-22,66.99473571777344,67.80060970558851,66.38621772867148,66.79737971906033,7033300.0,0.91278076171875,0.0,0.91278076171875,58.89973638836134,57.899746208653944,70.16890342789338,74.12888551837538,-25.87111448162461,1.4996318444376016,0.9513394005505477,0.05250860236757493,16384100.0,1.0
36,ABBV,2020-04-23,67.46345520019531,68.93541577095796,67.39766778082596,67.57858004717485,7869600.0,0.468719482421875,0.0,0.468719482421875,60.988474209801964,58.78290730030412,70.16890342789338,76.2388095219659,-23.761190478034088,1.5105172213017113,1.0632040064128605,0.044057027673166216,24253700.0,1.0
37,ABBV,2020-04-24,68.73805236816406,68.80383978643786,67.71837248025425,68.14598442520042,6770700.0,1.27459716796875,0.0,1.27459716796875,66.35366252893702,59.98207747330762,70.16890342789338,85.9539068782735,-14.0460931217265,1.598336458664761,1.170252730013291,0.05649635628802696,31024400.0,1.0
38,ABBV,2020-04-27,69.64260864257812,69.83173961412993,68.89429093001881,69.09987189186481,9209700.0,0.9045562744140625,0.0,0.9045562744140625,69.75927185151066,60.58972991550274,70.16890342789338,94.50584348812038,-5.494156511879618,1.717565208711335,1.2797334163520595,0.03116996757103352,40234100.0,1.0
39,ABBV,2020-04-28,68.05552673339844,70.69518566124515,67.73482091895757,70.47315469811939,8341000.0,-1.5870819091796875,1.5870819091796875,0.0,57.895710625467174,60.58972991550274,70.69518566124515,73.87887301412566,-26.121126985874344,1.669932359890737,1.3577835797060154,0.011488562351270382,31893100.0,-1.0
40,ABBV,2020-04-29,68.87786102294922,69.69196003840565,67.54569386451969,68.844967309599,8231700.0,0.8223342895507812,0.0,0.8223342895507812,61.78153641672472,63.652450632572545,70.69518566124515,74.1957544775264,-25.80424552247359,1.6765098004286756,1.4215356031284931,0.02321071334136593,40124800.0,1.0
41,ABBV,2020-04-30,67.59501647949219,68.46668400760086,66.79736763248809,68.22820934346576,15535800.0,-1.2828445434570312,1.2828445434570312,0.0,52.980278294564094,63.73347808120546,70.69518566124515,55.468264845802565,-44.531735154197435,1.5638280747009645,1.4499965186299104,-0.014979299677826963,24589000.0,-1.0
42,ABBV,2020-05-01,68.12132263183594,69.26435885576961,66.19708732838927,67.38945471483257,12705300.0,0.52630615234375,0.0,0.52630615234375,55.95082352497278,65.4734367719956,70.69518566124515,50.70879347131696,-49.29120652868305,1.4982511912181593,1.4596481100008314,-0.013691975077622875,37294300.0,1.0
43,ABBV,2020-05-04,67.31542205810547,68.12129581235132,66.70690424537236,67.61145910729071,6833000.0,-0.8059005737304688,0.8059005737304688,0.0,50.33263036031531,65.4734367719956,70.69518566124515,35.2752559569098,-64.7247440430902,1.3674647131334439,1.4412104267843961,0.01866571748476642,30461300.0,-1.0
44,ABBV,2020-05-05,70.20179748535156,71.11457756675594,67.92395664298792,68.21176876914384,10927000.0,2.8863754272460938,0.0,2.8863754272460938,64.89846921106972,65.80236154290925,71.11457756675594,82.81733880348835,-17.182661196511635,1.4729742440531197,1.4475634669520667,0.04787035478561208,41388300.0,1.0
45,ABBV,2020-05-06,70.24291229248047,72.48785950004175,70.1031187227418,70.95011141141427,17042600.0,0.04111480712890625,0.0,0.04111480712890625,65.06685111681605,65.80236154290925,72.48785950004175,66.42064327958944,-33.57935672041056,1.5419287878542889,1.4664371887857321,0.041199447671887324,58430900.0,1.0
46,ABBV,2020-05-07,69.25611114501953,71.41059547659589,68.71337442789003,71.14745211266928,11941800.0,-0.9868011474609375,0.9868011474609375,0.0,57.43662246127621,65.80236154290925,72.48785950004175,51.66031945945937,-48.33968054054063,1.5015245206256225,1.473454850777575,0.007536710148270176,46489100.0,-1.0
47,ABBV,2020-05-08,69.04232788085938,69.61795849179676,67.80061678358398,69.42059619864608,20188100.0,-0.21378326416015625,0.21378326416015625,0.0,55.80089519189698,65.80236154290925,72.48785950004175,48.462603065991935,-51.537396934008065,1.4360449590800357,1.4659727055806535,-0.008619446821694021,26301000.0,-1.0
48,ABBV,2020-05-11,72.28227233886719,72.74277171698672,69.05876414436341,69.96331918302685,19219800.0,3.2399444580078125,0.0,3.2399444580078125,70.49468954127647,66.19708732838927,72.74277171698672,92.96483987340234,-7.035160126597667,1.6212794925397134,1.4970346171354856,0.06210730866909109,45520800.0,1.0
49,ABBV,2020-05-12,74.3874282836914,75.8429452769711,72.75100528044085,74.00915999656905,23492300.0,2.1051559448242188,0.0,2.1051559448242188,76.38136282732702,66.19708732838927,75.8429452769711,84.91044548822447,-15.089554511775535,1.9124346723132248,1.5801158139454978,0.07999039428513144,69013100.0,1.0
50,ABBV,2020-05-13,73.07992553710938,75.85115299984237,72.1424768150088,74.61766717878021,23562600.0,-1.3075027465820312,1.3075027465820312,0.0,66.82649524288396,66.19708732838927,75.85115299984237,71.29471088095592,-28.70528911904407,2.0162287122794567,1.667339389529466,0.08114368992396459,45450500.0,-1.0
51,ABBV,2020-05-14,73.9598159790039,74.40387165230584,71.89578116620243,72.0520247199106,13379500.0,0.8798904418945312,0.0,0.8798904418945312,69.76348788901237,66.19708732838927,75.85115299984237,80.40890661816074,-19.591093381839258,2.1434867042103747,1.7625697223361934,0.08570728109203496,58830000.0,1.0
52,ABBV,2020-05-15,74.59300994873047,74.95483451956656,73.53221122646178,74.01738565315875,14071200.0,0.6331939697265625,0.0,0.6331939697265625,71.83406652331661,66.19708732838927,75.85115299984237,86.96773883740808,-13.03226116259192,2.2683940491605625,1.863735326969551,0.10811174717649563,72901200.0,1.0
53,ABBV,2020-05-18,75.21797943115234,77.01887105019154,75.0864045759557,75.65381015978106,16300200.0,0.624969482421875,0.0,0.624969482421875,73.87176559351255,66.19708732838927,77.01887105019154,83.35864340542123,-16.64135659457876,2.389452295333797,1.9688793353149614,0.07145375368554441,89201400.0,1.0
54,ABBV,2020-05-19,74.99593353271484,75.36598303406531,73.64732290403721,75.04527723052813,9892500.0,-0.2220458984375,0.2220458984375,0.0,71.74395454013094,66.19708732838927,77.01887105019154,81.30680145269258,-18.69319854730742,2.4395153461682213,2.063006977702264,0.06766549229114438,79308900.0,-1.0
55,ABBV,2020-05-20,74.98771667480469,76.09785265877791,73.92691811603768,75.7606968563132,10661500.0,-0.00821685791015625,0.00821685791015625,0.0,71.65582591073718,66.19708732838927,77.01887105019154,81.23087258438963,-18.769127415610363,2.450227347207857,2.140451341357147,0.08275956352477554,68647400.0,-1.0
56,ABBV,2020-05-21,76.4925765991211,76.58303274206801,74.29697299959349,75.06173457934105,10393200.0,1.5048599243164062,0.0,1.5048599243164062,77.49710871480974,66.70690424537236,77.01887105019154,94.89627477442534,-5.103725225574658,2.5493023365269067,2.222221785142741,0.10790842294770231,79040600.0,1.0
57,ABBV,2020-05-22,75.73603057861328,76.48434834541033,75.43177474828204,76.36922350033902,5507000.0,-0.7565460205078125,0.7565460205078125,0.0,69.22196523912181,67.80061678358398,77.01887105019154,86.08369400022683,-13.91630599977317,2.5381057822596773,2.2853987358448706,0.04778153934556029,73533600.0,-1.0
58,ABBV,2020-05-26,74.59300994873047,76.94485711149653,74.26407909104623,76.84617597204097,11869800.0,-1.1430206298828125,1.1430206298828125,0.0,58.35866030616943,67.80061678358398,77.01887105019154,73.68415937225156,-26.315840627748443,2.410086952762782,2.3103364269995788,0.0027636614113750735,61663800.0,-1.0
59,ABBV,2020-05-27,73.9926986694336,74.83146618931089,72.82499409924576,74.45319799220287,12529500.0,-0.600311279296875,0.600311279296875,0.0,53.29062959522324,67.80061678358398,77.01887105019154,67.17195801682293,-32.82804198317707,2.234846042979484,2.2952383270577887,0.012490066534902589,49134300.0,-1.0
60,ABBV,2020-05-28,74.03382873535156,74.98772758703892,74.00916001915866,74.72458415792417,8765900.0,0.04113006591796875,0.0,0.04113006591796875,53.609120721984134,67.80061678358398,77.01887105019154,67.61813865719601,-32.381861342803994,2.0753157231057315,2.251253752342446,0.0010007157990856719,57900200.0,1.0
61,ABBV,2020-05-29,76.20475006103516,76.3856623127678,73.68021607965937,74.83147073027641,13758800.0,2.1709213256835938,0.0,2.1709213256835938,67.22107798611052,69.05876414436341,77.01887105019154,89.77248674185134,-10.227513258148663,2.098477594627383,2.22069849083092,0.021607119935399766,71659000.0,1.0
62,ABBV,2020-06-01,74.58477020263672,76.5254549779802,74.57655148134974,75.6949124120166,8486500.0,-1.6199798583984375,1.6199798583984375,0.0,53.663542545301,71.89578116620243,77.01887105019154,52.48764119556114,-47.51235880443886,1.964392582810575,2.1694372690053627,-0.00841832276410992,63172500.0,-1.0
63,ABBV,2020-06-02,74.8643569946289,75.40708742203793,74.0502582165991,74.8067945815123,9413300.0,0.2795867919921875,0.0,0.2795867919921875,55.45271205181459,71.89578116620243,77.01887105019154,57.94502723256907,-42.05497276743093,1.8590923482374109,2.1073682458904153,-0.0017544489666034835,72585800.0,1.0
64,ABBV,2020-06-03,74.74103546142578,75.24265365436165,73.68023664065166,75.2179849356656,8588400.0,-0.123321533203125,0.123321533203125,0.0,54.38397762411637,71.89578116620243,77.01887105019154,55.53785624795421,-44.46214375204579,1.7456156214449976,2.035017684669185,-0.003289621611612392,63997400.0,-1.0
65,ABBV,2020-06-04,76.5090103149414,76.8708348097489,74.21472606382041,74.2393947750422,9525700.0,1.767974853515625,0.0,1.767974853515625,65.41122783758186,72.82499409924576,77.01887105019154,87.84273498689207,-12.157265013107937,1.7770241968064369,1.98341896636765,0.00021484066233568022,73523100.0,1.0
66,ABBV,2020-06-05,77.17509460449219,78.56482396429942,76.31987701952106,76.88728250229836,9630100.0,0.6660842895507812,0.0,0.6660842895507812,68.70042063555186,72.82499409924576,78.56482396429942,75.78796946110805,-24.21203053889195,1.8342121978714516,1.953577603077766,0.019001048970808787,83153200.0,1.0
67,ABBV,2020-06-08,77.78362274169922,78.12900358356639,76.31988705198705,76.40212446956703,6621400.0,0.6085281372070312,0.0,0.6085281372070312,71.55211841177827,72.82499409924576,78.56482396429942,86.38981919383252,-13.61018080616748,1.9063980547170871,1.944141690979562,0.04277361639062072,89774600.0,1.0
68,ABBV,2020-06-09,79.0828857421875,79.48582895906125,77.92341233805747,78.07964960847454,9555900.0,1.2992630004882812,0.0,1.2992630004882812,76.76690341190086,72.82499409924576,79.48582895906125,93.95055987193604,-6.049440128063961,2.044378067277833,1.9641889703627022,0.06879309937720479,99330500.0,1.0
69,ABBV,2020-06-10,79.68318176269531,81.69787267157722,79.60095063303682,79.75718789723804,11138300.0,0.6002960205078125,0.0,0.6002960205078125,78.83521791540016,72.82499409924576,81.69787267157722,77.29382981567709,-22.70617018432292,2.1768454445788166,2.00672027220447,0.07630772477725656,110468800.0,1.0
70,ABBV,2020-06-11,75.86760711669922,79.67496463285268,75.67846985336388,78.68817843187205,12584800.0,-3.8155746459960938,3.8155746459960938,0.0,47.69486630923153,72.82499409924576,81.69787267157722,34.291160333708675,-65.70883966629133,1.9526235895258708,1.9959009342444887,-0.004424172299835716,97884000.0,-1.0
71,ABBV,2020-06-12,76.03206634521484,77.90696381624046,74.8561429280248,77.08463992376724,8010100.0,0.164459228515625,0.0,0.164459228515625,48.702597760366785,72.82499409924576,81.69787267157722,36.144665114315764,-63.85533488568424,1.7677660329633653,1.9502739491831813,0.01940471410779998,105894100.0,1.0
72,ABBV,2020-06-15,76.54190826416016,77.3231134407089,74.65056083042816,75.05349777499715,7120200.0,0.5098419189453125,0.0,0.5098419189453125,52.00992468366296,72.82499409924576,81.69787267157722,41.8907362995472,-58.10926370045281,1.643318612407512,1.8888828766558596,0.022407876550006423,113014300.0,1.0
73,ABBV,2020-06-16,78.99242401123047,79.10754884393387,76.87083332724421,78.00563793839187,9366100.0,2.4505157470703125,0.0,2.4505157470703125,64.64981507950336,73.68021607965937,81.69787267157722,66.25636644161136,-33.74363355838862,1.7219563782631297,1.8554975747271485,0.056881584842356725,122380400.0,1.0
74,ABBV,2020-06-17,78.72928619384766,79.84764716799903,78.34279296800858,79.6420661988364,6212200.0,-0.2631378173828125,0.2631378173828125,0.0,62.60672944251193,73.68021607965937,81.69787267157722,62.97438729513524,-37.025612704864756,1.7430018688621658,1.8329984323410002,0.029019796096782846,116168200.0,-1.0
75,ABBV,2020-06-18,79.13220977783203,79.31311571579235,78.33455481156624,78.58124814905669,4571600.0,0.402923583984375,0.0,0.402923583984375,64.58417257745047,73.68023664065166,81.69787267157722,67.99975848430971,-32.0002415156903,1.7716740103928714,1.8207335474223176,0.025359413984131773,120739800.0,1.0
76,ABBV,2020-06-19,79.5269546508789,80.75221567521626,78.73752435020175,80.35750366179487,9210900.0,0.394744873046875,0.0,0.394744873046875,66.58189041266311,73.68023664065166,81.69787267157722,72.92321561711378,-27.07678438288621,1.8053506151150316,1.8176569608546915,0.022412583108514683,129950700.0,1.0
77,ABBV,2020-06-22,79.98744201660156,80.01211700332063,78.7950748856828,79.46938022450239,6004300.0,0.46048736572265625,0.0,0.46048736572265625,68.94011783757261,73.68023664065166,81.69787267157722,78.6666462735625,-21.333353726437494,1.8478028662357673,1.823686142097354,0.011438078743901015,135955000.0,1.0
78,ABBV,2020-06-23,80.02034759521484,81.49230832946522,79.80654786926858,80.93312775038594,6715600.0,0.03290557861328125,0.0,0.03290557861328125,69.11979122436632,74.21472606382041,81.69787267157722,77.58262447212381,-22.41737552787619,1.8626167859058853,1.8314722710310212,0.004231329937647965,142670600.0,1.0
79,ABBV,2020-06-24,78.23587799072266,79.89697541362412,77.58624150095743,79.32134504700366,9025100.0,-1.7844696044921875,1.7844696044921875,0.0,50.74989731717579,74.65056083042816,81.69787267157722,50.87496113567629,-49.12503886432371,1.7109190574170157,1.807361627882222,0.0312158372199689,133645500.0,-1.0
80,ABBV,2020-06-25,79.75718688964844,79.82297430207734,77.56158375895554,78.2687827579839,6411700.0,1.5213088989257812,0.0,1.5213088989257812,60.95702021498481,74.65056083042816,81.69787267157722,72.46204190089661,-27.53795809910339,1.6937037771133845,1.7846300574071485,0.04899407215266405,140057200.0,1.0
81,ABBV,2020-06-26,79.04999542236328,79.79008819812083,78.15366536949227,79.67496335231783,14568400.0,-0.7071914672851562,0.7071914672851562,0.0,54.858712592055554,74.65056083042816,81.69787267157722,62.4271309557631,-37.5728690442369,1.6045906572214221,1.7486221769628323,0.03276750234064263,125488800.0,-1.0
82,ABBV,2020-06-29,79.304931640625,80.0367995270775,78.67996361973444,79.35426907490982,6676400.0,0.25493621826171875,0.0,0.25493621826171875,56.662127360780914,74.65056083042816,81.69787267157722,66.04462687489007,-33.95537312510993,1.5367885720232692,1.7062554555916598,0.003956172168486649,132165200.0,1.0
83,ABBV,2020-06-30,80.73574829101562,81.31137242263198,78.80328867906643,78.9184135053897,8112500.0,1.430816650390625,0.0,1.430816650390625,65.5697565157501,74.65056083042816,81.49230832946522,88.94200584637076,-11.05799415362924,1.5801249993353252,1.6810293641578318,0.025485587310262847,140277700.0,1.0
84,ABBV,2020-07-01,81.52518463134766,81.95279653958309,80.1765740416814,80.99889787800633,6522900.0,0.7894363403320312,0.0,0.7894363403320312,69.55367508347987,74.65056083042816,81.95279653958309,94.14409606499923,-5.855903935000761,1.6589570246252663,1.6766148962257608,0.03024021267994459,146800600.0,1.0
85,ABBV,2020-07-02,81.3113784790039,82.224158437006,80.47261092848379,81.78010281361311,6158800.0,-0.21380615234375,0.21380615234375,0.0,67.12642315192079,74.65056083042816,82.224158437006,87.94786829961336,-12.052131700386633,1.6847751021489898,1.6782469374179658,0.02243797509861367,140641800.0,-1.0
86,ABBV,2020-07-06,81.41829681396484,82.06793349345112,80.54662915253783,81.9363586487701,7039000.0,0.1069183349609375,0.0,0.1069183349609375,67.77530186421598,76.87083332724421,82.224158437006,84.94652189960095,-15.053478100399042,1.6943186461094513,1.6814612791681733,0.01788849300951889,147680800.0,1.0
87,ABBV,2020-07-07,81.69786834716797,82.79978550253121,81.04823179173604,81.1469129064027,6345600.0,0.279571533203125,0.0,0.279571533203125,69.58652233066391,77.56158375895554,82.79978550253121,78.96382748689143,-21.03617251310856,1.7047621587147859,1.68612145509131,0.02096367739414129,154026400.0,1.0
88,ABBV,2020-07-08,81.64031219482422,82.70111073199367,81.0400192875926,82.02680541462625,6154400.0,-0.05755615234375,0.05755615234375,0.0,68.66968096186874,77.56158375895554,82.79978550253121,77.86505055615677,-22.134949443843215,1.6889268462080622,1.6866825333159912,0.04351499965917505,147872000.0,-1.0
89,ABBV,2020-07-09,80.53841400146484,82.05148713938794,79.60918387274316,81.4758628529681,5817300.0,-1.101898193359375,1.101898193359375,0.0,53.18904259190045,77.56158375895554,82.79978550253121,56.82924003757979,-43.17075996242021,1.5694499575660643,1.6632360181215247,0.009795068535921603,142054700.0,-1.0
90,ABBV,2020-07-10,79.62561798095703,80.85910372621011,79.23912477696446,80.6370727787181,6202500.0,-0.9127960205078125,0.9127960205078125,0.0,43.75975482780975,77.56158375895554,82.79978550253121,39.403488506965296,-60.5965114930347,1.3852016491944568,1.607629144251716,0.007281753218557396,135852200.0,-1.0
91,ABBV,2020-07-13,80.47262573242188,81.870573998403,79.69963917833384,80.0614637396234,8507400.0,0.8470077514648438,0.0,0.8470077514648438,52.7317285201882,77.56158375895554,82.79978550253121,55.57330771073396,-44.42669228926604,1.2925760205028638,1.5446185194254405,0.014724104385946069,144359600.0,1.0
92,ABBV,2020-07-14,82.2955093383789,82.48694875395161,79.85669209576098,80.7140226490675,6765600.0,1.8228836059570312,0.0,1.8228836059570312,66.14385749976282,77.56158375895554,82.79978550253121,90.3731053358003,-9.626894664199689,1.3505848120007045,1.5058117779027989,0.019319335986594854,151125200.0,1.0
93,ABBV,2020-07-15,83.63558959960938,83.63558959960938,82.2538680592065,83.2360537474426,5661600.0,1.3400802612304688,0.0,1.3400802612304688,72.7117186399478,77.56158375895554,83.63558959960938,100.0,-0.0,1.487469302466991,1.5021432828127865,0.025886540187610052,156786800.0,1.0
94,ABBV,2020-07-16,83.1694564819336,83.42749254542483,82.24553585393816,82.97801713042112,4269200.0,-0.46613311767578125,0.46613311767578125,0.0,67.45934442374991,78.15366536949227,83.63558959960938,91.49690695987923,-8.503093040120769,1.540599851476287,1.509834596550268,0.022851389777009734,152517600.0,-1.0
95,ABBV,2020-07-17,83.92692565917969,84.30148541060427,83.16947442132886,83.47745014722553,6890900.0,0.7574691772460938,0.0,0.7574691772460938,71.34098581842643,78.67996361973444,84.30148541060427,93.33703994471881,-6.662960055281182,1.6250578859393983,1.5328792544395546,0.03081161045344505,159408500.0,1.0
96,ABBV,2020-07-20,82.85316467285156,84.27650036135,82.62010474964572,83.8686454957398,4823300.0,-1.073760986328125,1.073760986328125,0.0,59.69407160817087,78.80328867906643,84.30148541060427,73.65825908983773,-26.34174091016227,1.5870968833285701,1.543722780221672,0.014141082858787346,154585200.0,-1.0
97,ABBV,2020-07-21,81.0719223022461,83.07790801119977,80.88047657339133,83.07790801119977,8239000.0,-1.7812423706054688,1.7812423706054688,0.0,45.48157012924906,79.23912477696446,84.30148541060427,36.20440458355615,-63.79559541644385,1.3972440949916205,1.5144270431663371,-0.006962122967165252,146346200.0,-1.0
98,ABBV,2020-07-22,81.32162475585938,81.80439540822417,80.68070991423569,81.40486589278287,4441800.0,0.24970245361328125,0.0,0.24970245361328125,47.50328160493883,79.23912477696446,84.30148541060427,41.136934517397435,-58.863065482602565,1.2524859290299588,1.462038820325722,0.00972468559388684,150788000.0,1.0
99,ABBV,2020-07-23,81.59629821777344,82.33709854946463,81.11352760711434,81.77109315947969,5127200.0,0.2746734619140625,0.0,0.2746734619140625,49.863081994444734,79.23912477696446,84.30148541060427,46.56273251544669,-53.43726748455331,1.146699734669113,1.398971003181553,0.024749324234917713,155915200.0,1.0
100,ABBV,2020-07-24,80.83051300048828,81.72946369039603,80.2894775102435,81.61293375100858,5169400.0,-0.7657852172851562,0.7657852172851562,0.0,43.56359722515179,79.23912477696446,84.30148541060427,31.435694504830675,-68.56430549516932,0.9896862034930223,1.3171140432305073,0.004447316895765496,150745800.0,-1.0
101,ABBV,2020-07-27,80.87216186523438,81.47978156895297,80.12303602809506,80.19794543660517,5030700.0,0.04164886474609375,0.0,0.04164886474609375,44.00751217630029,79.23912477696446,84.30148541060427,32.258410778130795,-67.7415892218692,0.8587125597459533,1.225433746521644,-0.017295566727609346,155776500.0,1.0
102,ABBV,2020-07-28,80.49760437011719,81.2550556725813,80.2895141903732,80.73898974066921,5941800.0,-0.3745574951171875,0.3745574951171875,0.0,40.68661634791714,79.23912477696446,84.30148541060427,24.859540523249674,-75.14045947675032,0.7164426822667025,1.1236355336600385,-0.03751973585066759,149834700.0,-1.0
103,ABBV,2020-07-29,80.7472915649414,81.07191164258936,80.43931590263668,80.6307616063194,5512000.0,0.24968719482421875,0.0,0.24968719482421875,43.94050934544996,79.23912477696446,84.30148541060427,29.79176904061421,-70.2082309593858,0.616725014392685,1.022253429798109,-0.029123250523085287,155346700.0,1.0
104,ABBV,2020-07-30,79.93990325927734,80.52255306967757,79.41551842991713,80.16463780031553,6411500.0,-0.8073883056640625,0.8073883056640625,0.0,36.474707248128325,79.41551842991713,84.30148541060427,10.732467727124675,-89.26753227287533,0.46718185726670924,0.9112391152844189,-0.04750587929424832,148935200.0,-1.0
105,ABBV,2020-07-31,78.99932861328125,80.94704890111322,77.86731796123321,79.52371337914235,14613000.0,-0.9405746459960938,0.9405746459960938,0.0,29.693188817129695,77.86731796123321,84.30148541060427,17.59373937584873,-82.40626062415127,0.26968294762635026,0.7829278817459533,-0.04651404777098511,134322200.0,-1.0
106,ABBV,2020-08-03,79.85668182373047,80.88048185457394,79.12420039636125,79.23241134380864,6919000.0,0.8573532104492188,0.0,0.8573532104492188,41.192731213173225,77.86731796123321,84.30148541060427,30.918745558785808,-69.08125444121418,0.18025039976897972,0.6623923853454095,-0.014989659107687903,141241200.0,1.0
107,ABBV,2020-08-04,78.4832763671875,79.93158193399815,78.29183064810461,79.84002176622899,7865100.0,-1.3734054565429688,1.3734054565429688,0.0,31.630214757562356,77.86731796123321,84.30148541060427,9.573241772165844,-90.42675822783416,-0.0014062595570294434,0.5296326563603845,-0.03490275061760084,133376100.0,-1.0
108,ABBV,2020-08-05,77.61761474609375,78.9077760300252,77.51772920236532,78.63309554757686,6918900.0,-0.86566162109375,0.86566162109375,0.0,27.06143942162241,77.51772920236532,84.30148541060427,1.4724223669347252,-98.52757763306528,-0.2127544785681721,0.38115522937061375,-0.048760587901438,126457200.0,-1.0
109,ABBV,2020-08-06,77.05160522460938,77.9505560186314,76.39403971881953,77.67587555094588,7269300.0,-0.566009521484375,0.566009521484375,0.0,24.40224039355654,76.39403971881953,84.27650036135,8.342134970416442,-91.65786502958356,-0.4210585654087424,0.22071247041123324,-0.046751005723000616,119187900.0,-1.0
110,ABBV,2020-08-07,77.34292602539062,77.40951638078332,76.74362552766802,77.15148669164391,5226600.0,0.29132080078125,0.0,0.29132080078125,28.57066745596552,76.39403971881953,83.07790801119977,14.196663744150213,-85.8033362558498,-0.5562257993948236,0.0653248164473029,-0.04363968711167732,124414500.0,1.0
111,ABBV,2020-08-10,76.89346313476562,77.96720897575986,76.70202376994118,77.1015532663442,7623600.0,-0.449462890625,0.449462890625,0.0,26.016858590011566,76.39403971881953,82.33709854946463,8.403474207100967,-91.59652579289903,-0.6916354723514644,-0.08606724131456979,-0.044773273236557554,116790900.0,-1.0
112,ABBV,2020-08-11,77.13484954833984,77.65091536815324,76.68537409567791,76.83519924656522,7208400.0,0.24138641357421875,0.0,0.24138641357421875,29.899743342694393,76.39403971881953,82.33709854946463,12.465126976370575,-87.53487302362942,-0.7705904649186408,-0.22297188603691712,-0.04473762458888464,123999300.0,1.0
113,ABBV,2020-08-12,79.4987564086914,79.55702139207582,77.68421018991062,77.78408938976567,7705600.0,2.3639068603515625,0.0,2.3639068603515625,55.99604221051429,76.39403971881953,81.72946369039603,58.19062751923164,-41.80937248076836,-0.6351211470641118,-0.3054017382430946,-0.005518481166472244,131704900.0,1.0
114,ABBV,2020-08-13,78.80789947509766,79.49043489240886,78.25021941408635,79.19078457745202,6004200.0,-0.69085693359375,0.69085693359375,0.0,49.750598666168536,76.39403971881953,81.47978156895297,47.46327728401691,-52.536722715983096,-0.5768501567733182,-0.3596914219495284,-0.002423174241399928,125700700.0,-1.0
115,ABBV,2020-08-14,79.13251495361328,79.63192999913703,78.69136489089387,79.39054468454573,5488100.0,0.324615478515625,0.0,0.324615478515625,52.6158831978914,76.39403971881953,81.2550556725813,56.33545046636883,-43.66454953363117,-0.4987303364815858,-0.38749920485609934,-0.00906833158577336,131188800.0,1.0
116,ABBV,2020-08-17,80.19792938232422,80.95538045224932,79.29065952537012,79.31562932320828,7251400.0,1.0654144287109375,0.0,1.0654144287109375,61.03089216161154,76.39403971881953,81.07191164258936,81.3166697483926,-18.683330251607398,-0.34686117005263384,-0.37937159789536895,0.021847367929884065,138440200.0,1.0
117,ABBV,2020-08-18,79.61529541015625,80.48927026010068,79.19911509578054,80.42268623611037,4557400.0,-0.5826339721679688,0.5826339721679688,0.0,54.88098160044252,76.39403971881953,80.95538045224932,70.62080821387309,-29.379191786126913,-0.27039563162071545,-0.35757640464035834,0.025737465272508198,133882800.0,-1.0
118,ABBV,2020-08-19,79.9898452758789,81.08856091614638,79.78175514438578,80.83053118522508,7672000.0,0.37454986572265625,0.0,0.37454986572265625,58.01885292727691,76.39403971881953,81.08856091614638,76.59578913195448,-23.40421086804552,-0.1775296304809899,-0.32156704980837897,0.03813340478377336,141554800.0,1.0
119,ABBV,2020-08-20,79.24073791503906,79.93159883596287,78.80791313530375,79.48212328561756,6798000.0,-0.7491073608398438,0.7491073608398438,0.0,49.99497728723576,76.39403971881953,81.08856091614638,60.63873346318043,-39.36126653681958,-0.16250073370696327,-0.2897537865880211,0.02453762725534081,134756800.0,-1.0
120,ABBV,2020-08-21,78.95771026611328,79.34059529880119,78.50823487546067,79.24070976185415,5269000.0,-0.28302764892578125,0.28302764892578125,0.0,47.152157523011596,76.39403971881953,81.08856091614638,54.609840695863866,-45.390159304136134,-0.17144989517360898,-0.2660930083050942,0.026845547686281224,129487800.0,-1.0
121,ABBV,2020-08-24,78.6664047241211,79.27402442628437,78.39172419280517,78.99102486098259,4103600.0,-0.2913055419921875,0.2913055419921875,0.0,44.16943673042146,76.39403971881953,81.08856091614638,48.40461699471065,-51.59538300528935,-0.1997437141903191,-0.2528231494821192,0.01985555406861117,125384200.0,-1.0
122,ABBV,2020-08-25,78.29183197021484,78.89945797108875,78.16698296697308,78.41668732386368,6710000.0,-0.37457275390625,0.37457275390625,0.0,40.37969662460776,76.39403971881953,81.08856091614638,40.42568286784934,-59.574317132150654,-0.24951320638385255,-0.2521611608624651,-0.0151816769594727,118674200.0,-1.0
123,ABBV,2020-08-26,78.53323364257812,78.58317960467947,77.35960831493516,77.82572829182503,5682800.0,0.24140167236328125,0.0,0.24140167236328125,43.955491741602366,76.68537409567791,81.08856091614638,41.966412560791895,-58.03358743920811,-0.26640704672541915,-0.2550103380350586,-0.0034852576245395506,124357000.0,1.0
124,ABBV,2020-08-27,78.49159240722656,79.12418177235686,77.96720126326085,78.51656220448089,5271500.0,-0.0416412353515625,0.0416412353515625,0.0,43.436967363525746,76.68537409567791,81.08856091614638,41.02070580226893,-58.97929419773107,-0.2799285458288949,-0.2599939795938297,-0.008099357726244705,119085500.0,-1.0
125,ABBV,2020-08-28,78.38339233398438,78.78292819657042,77.85068208414106,78.67471725961633,4938300.0,-0.1082000732421875,0.1082000732421875,0.0,41.95317633719291,76.68537409567791,81.08856091614638,38.56339300465577,-61.43660699534422,-0.29596305871824313,-0.2671877954187168,-0.022625734383857732,114147200.0,-1.0
126,ABBV,2020-08-31,79.71517944335938,79.91495057863747,78.25022922043472,78.3417894031685,9932300.0,1.331787109375,0.0,1.331787109375,60.914953416491,77.35960831493516,81.08856091614638,63.169779301005114,-36.830220698994886,-0.19891906197932485,-0.2535340487308317,0.0012545834652568644,124079500.0,1.0
127,ABBV,2020-09-01,76.77694702148438,79.84003456499032,75.98620691898041,79.50708902431202,15783600.0,-2.938232421875,2.938232421875,0.0,33.25829158098426,75.98620691898041,81.08856091614638,15.497554715787395,-84.5024452842126,-0.3549980292958139,-0.27382684484383607,-0.040166326654508366,108295900.0,-1.0
128,ABBV,2020-09-02,78.20027160644531,78.44165692945761,76.49393627884446,76.63543604910464,9139200.0,1.4233245849609375,0.0,1.4233245849609375,46.76721505816397,75.98620691898041,81.08856091614638,43.39300426224193,-56.60699573775807,-0.3597000386395308,-0.2910014836029804,-0.013130446989392364,117435100.0,1.0
129,ABBV,2020-09-03,76.46894073486328,78.4998954871754,75.81969438615502,78.14198031498191,8921900.0,-1.7313308715820312,1.7313308715820312,0.0,36.42066946917682,75.81969438615502,81.08856091614638,12.32231534074038,-87.67768465925963,-0.49739084381383236,-0.3322793556451612,-0.03152028500905146,108513200.0,-1.0
130,ABBV,2020-09-04,76.46894073486328,77.51771010885871,75.3951952182828,76.64373563052919,9444800.0,0.0,0.0,0.0,36.42066946917682,75.3951952182828,81.08856091614638,18.859591559056305,-81.1404084409437,-0.5995998929964372,-0.3857434631154272,-0.027933957284106192,108513200.0,1.0
131,ABBV,2020-09-08,75.0955810546875,76.46065205256642,74.45465977922007,76.17764612107992,8563900.0,-1.3733596801757812,1.3733596801757812,0.0,29.522845410692852,74.45465977922007,81.08856091614638,9.661302787584088,-90.33869721241591,-0.7823969007321949,-0.4650741506387936,-0.04082483236237622,99949300.0,-1.0
132,ABBV,2020-09-09,76.2691879272461,76.9350788464408,75.33694826086123,75.6282731566065,5373500.0,1.1736068725585938,0.0,1.1736068725585938,40.61309108372325,74.45465977922007,79.93159883596287,33.13033300584408,-66.86966699415592,-0.8230796716423328,-0.5366752548395106,-0.02882914162985062,105322800.0,1.0
133,ABBV,2020-09-10,74.6211166381836,76.0860728284319,74.47961688383631,75.80306696933097,10403600.0,-1.6480712890625,1.6480712890625,0.0,32.36172698591197,74.45465977922007,79.91495057863747,3.0484980576728318,-96.95150194232717,-0.9770397726484958,-0.6247481584013167,-0.0493107051384859,94919200.0,-1.0
134,ABBV,2020-09-11,74.66273498535156,75.19544520213876,74.11338035259271,74.7542951492125,8385800.0,0.04161834716796875,0.0,0.04161834716796875,32.75978424298714,74.11338035259271,79.91495057863747,9.46906805148463,-90.53093194851537,-1.0832094429487853,-0.7164404153108179,-0.04746741928161813,103305000.0,1.0
135,ABBV,2020-09-14,75.32029724121094,75.96121836009607,74.46296697216265,74.95406295225443,5212300.0,0.657562255859375,0.0,0.657562255859375,39.274887708273475,74.11338035259271,79.91495057863747,20.803279829313446,-79.19672017068655,-1.1015927374860865,-0.7934708797458767,-0.05513231272685226,108517300.0,1.0
136,ABBV,2020-09-15,75.66991424560547,76.56053994012318,75.44517330049447,76.0777692102778,3851300.0,0.34961700439453125,0.0,0.34961700439453125,42.6820027915303,74.11338035259271,79.91495057863747,26.829527737595406,-73.1704722624046,-1.0755527925940385,-0.8498872623155118,-0.01441881735111361,112368600.0,1.0
137,ABBV,2020-09-16,74.72931671142578,75.96953194616532,74.65440732260267,75.76144184333761,6304400.0,-0.9405975341796875,0.9405975341796875,0.0,36.3507326992872,74.11338035259271,79.91495057863747,10.61671814413224,-89.38328185586776,-1.1179257961681373,-0.9034949690860391,-0.044385458307454995,106064200.0,-1.0
138,ABBV,2020-09-17,74.60448455810547,75.58667040261847,74.22992479680805,74.32981036334441,5604700.0,-0.1248321533203125,0.1248321533203125,0.0,35.543358174415175,74.11338035259271,79.91495057863747,8.465022164310975,-91.53497783568902,-1.148341982065432,-0.9524643716819192,-0.024381875292641242,100459500.0,-1.0
139,ABBV,2020-09-18,75.00402069091797,75.3286408450907,73.96356985051617,74.48795478793181,10076300.0,0.3995361328125,0.0,0.3995361328125,40.42954737209261,73.96356985051617,79.91495057863747,17.48251183940379,-82.5174881605962,-1.1272145523697503,-0.9874144078194863,-0.01915705945273327,110535800.0,1.0
140,ABBV,2020-09-21,74.15499877929688,74.43800467014192,72.5568680381708,74.1966193471999,7328300.0,-0.8490219116210938,0.8490219116210938,0.0,34.09268157025602,72.5568680381708,79.84003456499032,21.942801050080586,-78.05719894991941,-1.165542964270628,-1.0230401191097154,-0.012525134797288007,103207500.0,-1.0
141,ABBV,2020-09-22,73.74713134765625,74.03845622222751,73.18945139484754,73.99684201180646,5306100.0,-0.407867431640625,0.407867431640625,0.0,31.367453059869646,72.5568680381708,78.4998954871754,20.02789520490613,-79.97210479509387,-1.214825654576316,-1.0613972262030362,-0.03306783051100082,97901400.0,-1.0
142,ABBV,2020-09-23,72.53189086914062,74.30481638461674,72.51524645391454,74.08008185182935,6253000.0,-1.215240478515625,1.215240478515625,0.0,24.605586591018763,72.51524645391454,78.4998954871754,0.2781184850369288,-99.72188151496307,-1.336534004449362,-1.116424581852302,-0.027997782171674368,91648400.0,-1.0
143,ABBV,2020-09-24,71.50810241699219,72.4153724256234,71.01700635925023,72.4153724256234,9980800.0,-1.0237884521484375,1.0237884521484375,0.0,20.342796931524816,71.01700635925023,77.51771010885871,7.55450604515755,-92.44549395484245,-1.498326906879086,-1.1928050468576594,-0.04225176815419762,81667600.0,-1.0
144,ABBV,2020-09-25,71.77445220947266,72.29883706389944,71.13353103698851,71.58300649095732,9935600.0,0.26634979248046875,0.0,0.26634979248046875,24.28062925647194,71.01700635925023,76.9350788464408,12.798860640214963,-87.20113935978505,-1.586765722766529,-1.271597182039434,-0.04707688580121794,91603200.0,1.0
145,ABBV,2020-09-28,72.6484375,73.41420778427494,72.30717293108943,72.65676288472696,6306900.0,0.8739852905273438,0.0,0.8739852905273438,36.21849282457499,71.01700635925023,76.9350788464408,27.566934069850195,-72.43306593014981,-1.5682537752873884,-1.3309285006890255,-0.03992969697043025,97910100.0,1.0
146,ABBV,2020-09-29,72.32380676269531,72.64842686503891,71.84103612573054,72.50692709743414,5508900.0,-0.3246307373046875,0.3246307373046875,0.0,33.9261102146272,71.01700635925023,76.56053994012318,23.57341909055952,-76.42658090944047,-1.5617744194073424,-1.377097684432689,-0.03218964195831697,92401200.0,-1.0
147,ABBV,2020-09-30,72.90645599365234,73.61396752660454,72.2572157943659,72.41536632767149,8209300.0,0.5826492309570312,0.0,0.5826492309570312,41.583140784063325,71.01700635925023,76.56053994012318,34.083849350554104,-65.91615064944591,-1.4924213191326743,-1.400162411372686,-0.02276040876779495,100610500.0,1.0
148,ABBV,2020-10-01,72.53189086914062,73.38922113742824,72.1906263785514,73.38922113742824,8777300.0,-0.37456512451171875,0.37456512451171875,0.0,38.291580133363155,71.01700635925023,76.56053994012318,27.327055708966103,-72.6729442910339,-1.450956722682733,-1.4103212736346953,-0.03295996399932577,91833200.0,-1.0
149,ABBV,2020-10-02,71.68289184570312,72.70669175160081,71.62462686203746,71.99918656411575,5554300.0,-0.8489990234375,0.8489990234375,0.0,31.724063979093458,71.01700635925023,76.56053994012318,12.011932041873473,-87.98806795812652,-1.4696608839617653,-1.4221891957001094,-0.03333702345476852,86278900.0,-1.0
150,ABBV,2020-10-05,73.18946075439453,73.39755088432851,71.75779964438368,71.99085957384465,5984200.0,1.5065689086914062,0.0,1.5065689086914062,49.46933364485292,71.01700635925023,75.96953194616532,43.86558649760586,-56.13441350239414,-1.347385711219502,-1.4072284988039878,-0.007561929299090497,92263100.0,1.0
151,ABBV,2020-10-06,71.49143981933594,73.29766050399833,71.34161468164375,73.22275111035542,8743800.0,-1.6980209350585938,1.6980209350585938,0.0,36.97259212534088,71.01700635925023,75.58667040261847,10.382239385283293,-89.61776061471672,-1.3716848581412222,-1.4001197706714348,-0.014344739084244051,83519300.0,-1.0
152,ABBV,2020-10-07,72.47362518310547,72.66507088357274,71.60796954044793,71.71618046478409,5899700.0,0.9821853637695312,0.0,0.9821853637695312,46.06591060273082,71.01700635925023,75.3286408450907,33.78344868144121,-66.21655131855879,-1.296740485655576,-1.379443913668263,0.013502284824773225,89419000.0,1.0
153,ABBV,2020-10-08,72.69837951660156,73.73051134307845,72.34878955137943,72.64011452239787,5535100.0,0.22475433349609375,0.0,0.22475433349609375,48.045076450998614,71.01700635925023,74.43800467014192,49.14861115242929,-50.85138884757071,-1.205316702467357,-1.3446184714280818,0.012872648674941312,94954100.0,1.0
154,ABBV,2020-10-09,72.99800872802734,73.83036917578322,72.70668384139404,72.75662978653564,6005800.0,0.29962921142578125,0.0,0.29962921142578125,50.821090840547946,71.01700635925023,74.30481638461674,60.252945075689965,-39.747054924310035,-1.0960506724862427,-1.2949049116397138,0.004811820323421978,100959900.0,1.0
155,ABBV,2020-10-12,73.51408386230469,73.74714380131847,72.68172330845142,73.38922850914528,7314900.0,0.5160751342773438,0.0,0.5160751342773438,55.541960401336176,71.01700635925023,74.30481638461674,75.94956776056708,-24.050432239432922,-0.956784619581029,-1.2272808532279769,0.016457611302386876,108274800.0,1.0
156,ABBV,2020-10-13,73.10623931884766,73.91363018645463,72.80658896900573,73.25606449376862,7851700.0,-0.40784454345703125,0.40784454345703125,0.0,51.07150852345356,71.01700635925023,73.91363018645463,72.12648532321842,-27.873514676781586,-0.8693039459772791,-1.1556854717778373,0.0027402693283116175,100423100.0,-1.0
157,ABBV,2020-10-14,72.61688232421875,73.49432654831197,72.47345561254912,73.2580928027651,5863900.0,-0.48935699462890625,0.48935699462890625,0.0,45.95109394339207,71.13353103698851,73.91363018645463,53.35605701383339,-46.64394298616661,-0.8298951908974601,-1.090527415601762,0.001171780496271202,94559200.0,-1.0
158,ABBV,2020-10-15,71.90818786621094,72.33846804178141,71.68038642089724,72.06005335079092,6190900.0,-0.7086944580078125,0.7086944580078125,0.0,39.35733239979015,71.34161468164375,73.91363018645463,22.028373604569325,-77.97162639543068,-0.8460956617543474,-1.041641064832279,0.0031429538444509575,88368300.0,-1.0
159,ABBV,2020-10-16,72.7856216430664,73.52807794232244,72.35534149169253,72.46501961004306,5358500.0,0.8774337768554688,0.0,0.8774337768554688,49.67387336745002,71.34161468164375,73.91363018645463,56.1430115301283,-43.8569884698717,-0.7791517898581901,-0.9891432098374612,-0.005517722185210627,93726800.0,1.0
160,ABBV,2020-10-19,71.1319808959961,73.22434901977414,70.98011541574698,73.05560602122667,10288000.0,-1.6536407470703125,1.6536407470703125,0.0,36.259906863824085,70.98011541574698,73.91363018645463,5.176912070310795,-94.82308792968921,-0.8497375141457439,-0.9612620706991178,-0.005027999495439195,83438800.0,-1.0
161,ABBV,2020-10-20,71.08135223388672,71.57069721251577,70.38108336138856,71.03073255916178,6932100.0,-0.050628662109375,0.050628662109375,0.0,35.91726873594776,70.38108336138856,73.91363018645463,19.823342964040137,-80.17665703595986,-0.8993948324043544,-0.9488886230401652,-0.01921075350793,76506700.0,-1.0
162,ABBV,2020-10-21,69.9339370727539,70.98855671305589,69.65551594286119,70.51608917400458,9776900.0,-1.1474151611328125,1.1474151611328125,0.0,28.800523413940766,69.65551594286119,73.91363018645463,6.538601689976257,-93.46139831002375,-1.0195820086157852,-0.9630273001552894,-0.03802619071056956,66729800.0,-1.0
163,ABBV,2020-10-22,71.1319808959961,71.62132593645292,69.95924441286188,70.04361269369201,8080100.0,1.1980438232421875,0.0,1.1980438232421875,42.521463024163495,69.65551594286119,73.91363018645463,34.67415077827769,-65.32584922172231,-1.0065564183133375,-0.971733123786899,-0.0255627223885464,74809900.0,1.0
164,ABBV,2020-10-23,71.15728759765625,71.84068544707472,70.81981448922241,71.41039886586856,4238700.0,0.02530670166015625,0.0,0.02530670166015625,42.79017585999994,69.65551594286119,73.91363018645463,35.26846789173306,-64.73153210826695,-0.9828616879067198,-0.9739588366108632,-0.03205911222484692,79048600.0,1.0
165,ABBV,2020-10-26,70.80294036865234,71.14041993016471,69.86643764297698,70.94636709030675,7986300.0,-0.35434722900390625,0.35434722900390625,0.0,39.78516997279569,69.65551594286119,73.91363018645463,26.94677409178298,-73.05322590821703,-0.9813636744383558,-0.9754398041763619,-0.03150618841368158,71062300.0,-1.0
166,ABBV,2020-10-27,69.78206634521484,71.0897971757107,69.7567565056508,70.87043450467739,6705600.0,-1.0208740234375,1.0208740234375,0.0,32.255217296547514,69.65551594286119,73.91363018645463,2.9719823169155153,-97.02801768308449,-1.0504434270865914,-0.9904405287584079,-0.039037974204773285,64356700.0,-1.0
167,ABBV,2020-10-28,67.90907287597656,69.36023067624373,67.6981489267956,68.63465177611015,11480200.0,-1.8729934692382812,1.8729934692382812,0.0,23.028477523424428,67.6981489267956,73.91363018645463,3.3935256236704827,-96.60647437632952,-1.2420071170814708,-1.0407538464230206,-0.05561418120666517,52876500.0,-1.0
168,ABBV,2020-10-29,68.06092071533203,68.65151148191572,66.74475767378588,67.91749401196076,8876700.0,0.15184783935546875,0.0,0.15184783935546875,25.034473942667972,66.74475767378588,73.91363018645463,18.35941480644607,-81.64058519355393,-1.365825500335987,-1.1057681772056138,-0.06491255856690825,61753200.0,1.0
169,ABBV,2020-10-30,71.79849243164062,72.67593660556851,70.02673300444755,70.19546954536635,18089100.0,3.7375717163085938,0.0,3.7375717163085938,56.92046450065524,66.74475767378588,73.91363018645463,70.49553118602464,-29.50446881397536,-1.1491159414748324,-1.1144377300594577,0.009370068529640063,79842300.0,1.0
170,ABBV,2020-11-02,74.45614624023438,74.7008187680112,72.55783089699894,72.58314073834009,10781400.0,2.65765380859375,0.0,2.65765380859375,68.06500093429595,66.74475767378588,74.7008187680112,96.92470275329565,-3.07529724670436,-0.7542277192672486,-1.0423957279010159,0.04747790946974684,90623700.0,1.0
171,ABBV,2020-11-03,74.21146392822266,75.41794888922163,73.76430629178363,75.20702499000423,8518800.0,-0.24468231201171875,0.24468231201171875,0.0,66.24449187800761,66.74475767378588,75.41794888922163,86.08949196402142,-13.910508035978575,-0.455765961264575,-0.9250697745737276,0.061165251586204006,82104900.0,-1.0
172,ABBV,2020-11-04,79.72924041748047,82.25188865587448,78.18527580422557,78.58181379705042,25849000.0,5.5177764892578125,0.0,5.5177764892578125,80.0964086017022,66.74475767378588,82.25188865587448,83.73233423185901,-16.26766576814099,0.22342934068397824,-0.6953699515221864,0.12086349084042314,107953900.0,1.0
173,ABBV,2020-11-05,79.04584503173828,80.58980313083082,78.46369299167371,80.45481517824132,8013000.0,-0.6833953857421875,0.6833953857421875,0.0,75.65946090570182,66.74475767378588,82.25188865587448,79.32535923092856,-20.674640769071456,0.6985004044044842,-0.41659588033685224,0.11086085066488494,99940900.0,-1.0
174,ABBV,2020-11-06,78.33714294433594,79.01210206605228,77.37533037986684,78.446827502825,7006900.0,-0.7087020874023438,0.7087020874023438,0.0,70.95617846574359,66.74475767378588,82.25188865587448,74.75519026659255,-25.244809733407443,1.0062123864498886,-0.132034226979504,0.10641087130640314,92934000.0,-1.0
175,ABBV,2020-11-09,80.2523193359375,81.79627722927158,79.87265249379757,80.77540643323094,11028900.0,1.9151763916015625,0.0,1.9151763916015625,75.67181661394883,66.74475767378588,82.25188865587448,87.10548506847225,-12.894514931527755,1.388607876724322,0.17209419376126128,0.1500421747175824,103962900.0,1.0
176,ABBV,2020-11-10,83.41619110107422,83.63554733516926,80.68261256483162,81.00322103093308,12267200.0,3.1638717651367188,0.0,3.1638717651367188,81.42161555384473,66.74475767378588,83.63554733516926,98.70132635304465,-1.2986736469553515,1.924769231034631,0.5226292012159354,0.22835119916036195,116230100.0,1.0
177,ABBV,2020-11-11,82.8087387084961,84.25989642066327,82.48813020559683,83.65243445399909,9476500.0,-0.607452392578125,0.607452392578125,0.0,77.37063268371216,66.74475767378588,84.25989642066327,91.71483747209318,-8.285162527906822,2.2744462764667475,0.872992616266098,0.21668554933083395,106753600.0,-1.0
178,ABBV,2020-11-12,82.34468078613281,82.47123640046723,81.23100296638455,82.26031252220517,7646600.0,-0.46405792236328125,0.46405792236328125,0.0,74.12002828363849,66.74475767378588,84.25989642066327,89.06536989396157,-10.93463010603842,2.4854713205358934,1.1954883571200572,0.14688593029349772,99107000.0,-1.0
179,ABBV,2020-11-13,83.55962371826172,83.9899103318016,82.17596327167021,82.18440203108126,6888600.0,1.2149429321289062,0.0,1.2149429321289062,77.03471215742985,66.74475767378588,84.25989642066327,96.00190034163222,-3.998099658367787,2.719398304531964,1.5002703466024387,0.12226629952958845,105995600.0,1.0
180,ABBV,2020-11-16,82.98590087890625,84.8251575698244,82.960591040458,84.33581257020245,8611300.0,-0.5737228393554688,0.5737228393554688,0.0,72.58078134068262,66.74475767378588,84.8251575698244,89.8273450725991,-10.172654927400895,2.825917105154616,1.7653996983128746,0.1182355998147433,97384300.0,-1.0
181,ABBV,2020-11-17,83.70303344726562,84.58891633580573,83.30649551500264,83.83802782288116,11593500.0,0.717132568359375,0.0,0.717132568359375,74.69122311095538,66.74475767378588,84.8251575698244,93.79369854090099,-6.206301459099005,2.9343749301137194,1.9991947446730436,0.04984109981454066,108977800.0,1.0
182,ABBV,2020-11-18,83.2896499633789,84.61425210486568,83.25590135913164,84.36957955173906,8880600.0,-0.41338348388671875,0.41338348388671875,0.0,71.05369348864942,70.02673300444755,84.8251575698244,89.62384408109195,-10.376155918908045,2.952932397855605,2.1899422753095563,0.0536878937778027,100097200.0,-1.0
183,ABBV,2020-11-19,84.09114074707031,84.49611747616136,83.17994793428053,83.32338108145268,7550300.0,0.8014907836914062,0.0,0.8014907836914062,73.89757290154469,72.55783089699894,84.8251575698244,94.01648914771238,-5.9835108522876235,2.997756614143782,2.3515051430764013,0.07345171889690949,107647500.0,1.0
184,ABBV,2020-11-20,85.07826232910156,85.91352561860462,83.20526347954382,84.32737375021337,9682500.0,0.98712158203125,0.0,0.98712158203125,77.09543731613707,73.76430629178363,85.91352561860462,93.12496328336827,-6.875036716631723,3.077457523564135,2.4966956191739484,0.06013462331178965,117330000.0,1.0
185,ABBV,2020-11-23,86.2088394165039,86.6981845384978,85.27233653840426,86.0063542213951,7541500.0,1.1305770874023438,0.0,1.1305770874023438,80.28703755234152,77.37533037986684,86.6981845384978,94.75112327547392,-5.248876724526083,3.1950189460954874,2.6363602845582563,0.03347849234743738,124871500.0,1.0
186,ABBV,2020-11-24,87.71060943603516,88.43618829630435,86.5463116178042,86.79941648078254,9322200.0,1.50177001953125,0.0,1.50177001953125,83.75620420240641,77.37533037986684,88.43618829630435,93.4401213201472,-6.5598786798528,3.3705142529498175,2.7831910782365687,0.0591950898418423,134193700.0,1.0
187,ABBV,2020-11-25,87.91309356689453,88.13245626170705,87.229702077037,87.59249150285137,6368100.0,0.202484130859375,0.0,0.202484130859375,84.1890824967891,77.37533037986684,88.43618829630435,95.27075807896918,-4.72924192103083,3.4857527256873198,2.923703407726719,0.06762322383912212,140561800.0,1.0
188,ABBV,2020-11-27,88.4952392578125,89.26300541542965,87.99746189689455,88.57117521610594,4418800.0,0.5821456909179688,0.0,0.5821456909179688,85.47328715751118,79.87265249379757,89.26300541542965,91.82388389419867,-8.176116105801334,3.5827545489074737,3.0555136359628703,0.059066990969133704,144980600.0,1.0
189,ABBV,2020-11-30,88.23368835449219,88.94238957651059,87.44905118046513,88.68928475588402,20726500.0,-0.2615509033203125,0.2615509033203125,0.0,82.0197200784413,80.68261256483162,89.26300541542965,88.00384692332919,-11.996153076670817,3.5970595626355504,3.1638228212974067,0.06323709714549652,124254100.0,-1.0
190,ABBV,2020-12-01,87.77808380126953,89.75232825373543,87.77808380126953,88.63021808974845,7623500.0,-0.45560455322265625,0.45560455322265625,0.0,75.85909361923895,81.23100296638455,89.75232825373543,76.8317205846316,-23.168279415368414,3.530930551263012,3.2372443672905282,0.04868461973449567,116630600.0,-1.0
191,ABBV,2020-12-02,88.57960510253906,88.90864589335912,87.17063490216738,87.74434820560256,5492200.0,0.8015213012695312,0.0,0.8015213012695312,79.0528798072854,81.23100296638455,89.75232825373543,86.23778448010705,-13.762215519892953,3.5028205438498077,3.2903596026023845,0.06351275508404775,122122800.0,1.0
192,ABBV,2020-12-03,88.36869049072266,89.17863763314556,87.99746874016697,88.58805318665627,4693600.0,-0.21091461181640625,0.21091461181640625,0.0,76.00002933956696,82.17596327167021,89.75232825373543,81.73744577659443,-18.26255422340557,3.4240537571804026,3.3170984335179887,0.05086801898095761,117429200.0,-1.0
193,ABBV,2020-12-04,90.51165771484375,90.53696755148131,88.60490396655061,88.60490396655061,7235800.0,2.1429672241210938,0.0,2.1429672241210938,83.47946359349683,82.960591040458,90.53696755148131,99.66593744911256,-0.3340625508874364,3.494270230248034,3.352532792863998,0.06386349740812292,124665000.0,1.0
194,ABBV,2020-12-07,89.2967529296875,90.45261839649999,88.55430300493126,90.30919166732338,6532500.0,-1.21490478515625,1.21490478515625,0.0,69.34314853505748,83.17994793428053,90.53696755148131,83.14243149638777,-16.857568503612228,3.4125469369886474,3.364535621688928,0.035818989492073294,118132500.0,-1.0
195,ABBV,2020-12-08,90.85758972167969,91.41442552257931,89.09426240557532,89.17863068608894,6688200.0,1.5608367919921875,0.0,1.5608367919921875,75.49464435917395,83.17994793428053,91.41442552257931,93.23775194080453,-6.762248059195472,3.4341404551287695,3.378456588376896,0.03587912917124969,124820700.0,1.0
196,ABBV,2020-12-09,91.68441009521484,92.08938686309664,90.80696579554376,91.03476723900457,7350700.0,0.8268203735351562,0.0,0.8268203735351562,78.1717948954395,83.17994793428053,92.08938686309664,95.45451996340688,-4.5454800365931165,3.477880113164119,3.3983412933343407,0.04289823478286148,132171400.0,1.0
197,ABBV,2020-12-10,90.6888427734375,92.02188343290298,89.99701260434188,92.01344467415304,6285700.0,-0.9955673217773438,0.9955673217773438,0.0,67.87032738940496,83.20526347954382,92.08938686309664,84.23542729886032,-15.764572701139686,3.393096655026696,3.397292365672812,0.02478781383068962,125885700.0,-1.0
198,ABBV,2020-12-11,89.71859741210938,90.62979031056362,89.07739331635624,90.28387842165566,5205200.0,-0.970245361328125,0.970245361328125,0.0,59.11090497464278,85.27233653840426,92.08938686309664,65.2226500015717,-34.777349998428306,3.2106046251391973,3.359954817566089,0.016829275589742343,120680500.0,-1.0
199,ABBV,2020-12-14,87.91309356689453,91.17819839922385,87.82028652050799,90.63823364036818,8272700.0,-1.8055038452148438,1.8055038452148438,0.0,46.284710346492524,86.5463116178042,92.08938686309664,24.657466994537064,-75.34253300546294,2.8870096822309677,3.265365790499065,0.0015380805752227555,112407800.0,-1.0
200,ABBV,2020-12-15,86.7488021850586,88.96771982910802,86.32695428366522,88.95928750563962,12101000.0,-1.1642913818359375,1.1642913818359375,0.0,39.85075626778189,86.32695428366522,92.08938686309664,7.320656607751603,-92.6793433922484,2.5077025567153157,3.1138331437423155,-0.020668447498283005,100306800.0,-1.0
201,ABBV,2020-12-16,88.28431701660156,88.93396630645815,85.97259261445319,86.47880874411445,9182100.0,1.5355148315429688,0.0,1.5355148315429688,50.35283161685894,85.97259261445319,92.08938686309664,37.79307114443249,-62.20692885556751,2.3044379938118738,2.9519541137562273,-0.000954789231939035,109488900.0,1.0
202,ABBV,2020-12-17,88.4952392578125,89.00989413696774,87.83715765807621,88.46992941734375,6360600.0,0.2109222412109375,0.0,0.2109222412109375,51.689736870933636,85.97259261445319,92.08938686309664,41.24131924036468,-58.75868075963532,2.135749432451931,2.788713177495368,-0.022277997198813404,115849500.0,1.0
203,ABBV,2020-12-18,88.12400817871094,88.63866304080994,87.06938861488295,88.61335320117999,13906800.0,-0.3712310791015625,0.3712310791015625,0.0,49.009598899291795,85.97259261445319,92.08938686309664,35.17227287373411,-64.82772712626588,1.9496331334101882,2.6208971686783324,-0.013133117526680782,101942700.0,-1.0
204,ABBV,2020-12-21,87.49967956542969,87.67685488856728,85.67730021538064,86.69817123168048,6664600.0,-0.62432861328125,0.62432861328125,0.0,44.52922006269269,85.67730021538064,92.08938686309664,28.421003179958344,-71.57899682004165,1.731793493131491,2.4430764335689643,-0.03695794887951731,95278100.0,-1.0
205,ABBV,2020-12-22,86.73192596435547,87.32251041657236,86.06540554720341,87.24658088852493,4002900.0,-0.7677536010742188,0.7677536010742188,0.0,39.41633157208546,85.67730021538064,92.08938686309664,16.44746565223802,-83.55253434776198,1.4801405776848497,2.2504892623921413,-0.05401664389525096,91275200.0,-1.0
206,ABBV,2020-12-23,87.13689422607422,87.68529773959798,86.8247309246452,86.95128013501501,3659100.0,0.40496826171875,0.0,0.40496826171875,43.37352937457826,85.67730021538064,92.08938686309664,22.763167294588733,-77.23683270541126,1.298414070542151,2.0600742240221432,-0.0391663234278653,94934300.0,1.0
207,ABBV,2020-12-24,87.12001037597656,87.22968848785264,86.56316818440568,86.99345474726621,1378600.0,-0.01688385009765625,0.01688385009765625,0.0,43.237668980150524,85.67730021538064,92.08938686309664,22.499854413380707,-77.5001455866193,1.139892151680769,1.8760378095538683,-0.028963750115225007,93555700.0,-1.0
208,ABBV,2020-12-28,87.28031158447266,87.64310096798455,86.66441737050936,87.44905457499384,3948900.0,0.16030120849609375,0.0,0.16030120849609375,45.120835878712455,85.67730021538064,92.08938686309664,24.99983947757496,-75.00016052242503,1.0154914026683315,1.703928528176761,-0.007197812711941309,97504600.0,1.0
209,ABBV,2020-12-29,88.33493041992188,88.90021138747102,87.70215869359897,87.70215869359897,5096400.0,1.0546188354492188,0.0,1.0546188354492188,56.16141290573279,85.67730021538064,92.08938686309664,41.447197309597975,-58.552802690402025,0.9905830071115673,1.5612594239637223,0.018284151422398143,102601000.0,1.0
210,ABBV,2020-12-30,88.81584167480469,89.62579519455902,88.67241495361606,88.68085371277046,5328400.0,0.4809112548828125,0.0,0.4809112548828125,60.35765857521984,85.67730021538064,92.02188343290298,49.46804781054943,-50.53195218945057,0.9981424748497858,1.4486360341409352,0.0060206011233363554,107929400.0,1.0
211,ABBV,2020-12-31,90.40198516845703,90.51166327959166,88.46148270638102,88.80740099339171,6148100.0,1.5861434936523438,0.0,1.5861434936523438,70.94256587998407,85.67730021538064,91.17819839922385,85.8893365260487,-14.110663473951307,1.1192202472566493,1.3827528767640782,0.02154631058841061,114077500.0,1.0
212,ABBV,2021-01-04,88.93395233154297,90.57071734568659,87.62622163493238,90.42729064491638,9523400.0,-1.4680328369140625,1.4680328369140625,0.0,55.20190311035993,85.67730021538064,91.17819839922385,59.20218857581303,-40.79781142418696,1.084219078616897,1.3230461171346422,0.009190959076549321,104554100.0,-1.0
213,ABBV,2021-01-05,89.85357666015625,90.2922955167834,88.27586365410262,88.93395159437273,6823800.0,0.9196243286132812,0.0,0.9196243286132812,61.39345661529879,85.67730021538064,90.57071734568659,85.34478736568487,-14.655212634315143,1.1178010780199799,1.2819971093117097,0.02690177959984852,111377900.0,1.0
214,ABBV,2021-01-06,89.07738494873047,90.43573540950679,87.89620979541802,88.37711604050185,11017500.0,-0.7761917114257812,0.7761917114257812,0.0,54.11019928592502,85.67730021538064,90.57071734568659,69.48283056215251,-30.51716943784748,1.0694548639663424,1.2394886602426363,0.02704262540346347,100360400.0,-1.0
215,ABBV,2021-01-07,90.03075408935547,90.32604625340377,89.0689416482345,89.52453803143176,8196000.0,0.953369140625,0.0,0.953369140625,60.71513805720903,85.67730021538064,90.57071734568659,88.96551751153574,-11.034482488464258,1.0954414910099644,1.210679226396102,0.03321050043134677,108556400.0,1.0
216,ABBV,2021-01-08,90.50321960449219,90.72258225173083,89.22924394745479,90.14043025735708,5345900.0,0.47246551513671875,0.0,0.47246551513671875,63.70248999571736,85.67730021538064,90.72258225173083,95.65212319830331,-4.347876801696684,1.1410072749666114,1.196744836110204,0.03883389377382973,113902300.0,1.0
217,ABBV,2021-01-11,91.97968292236328,92.43527927640288,90.33447923018082,90.33447923018082,6334200.0,1.4764633178710938,0.0,1.4764633178710938,71.51340839699026,85.67730021538064,92.43527927640288,93.25839352377804,-6.741606476221959,1.2814845751368438,1.213692783915532,0.053842284159840936,120236500.0,1.0
218,ABBV,2021-01-12,92.62090301513672,93.4645986249476,92.0640672598426,92.14843553344636,6106900.0,0.6412200927734375,0.0,0.6412200927734375,74.2862384203595,86.06540554720341,93.4645986249476,88.59746460261178,-11.402535397388215,1.4280927830742485,1.2565727837472753,0.048519567229412086,126343400.0,1.0
219,ABBV,2021-01-13,94.87357330322266,95.68352679198607,92.55341026485505,92.63778497939617,9821300.0,2.2526702880859375,0.0,2.2526702880859375,81.56147775636254,86.56316818440568,95.68352679198607,91.1192802431012,-8.880719756898806,1.7063823883735267,1.3465347046725258,0.06820553083984815,136164700.0,1.0
220,ABBV,2021-01-14,95.28327178955078,96.18805334388634,93.46518424854973,94.48945763544612,8268800.0,0.409698486328125,0.0,0.409698486328125,82.59488882575359,86.56316818440568,96.18805334388634,90.59956000156185,-9.400439998438149,1.9376521006333292,1.4647581838646866,0.05399534769062697,144433500.0,1.0
221,ABBV,2021-01-15,94.3358154296875,95.223522065535,93.44811530601133,94.91623874881196,9196200.0,-0.9474563598632812,0.9474563598632812,0.0,71.84968562959288,86.66441737050936,96.18805334388634,80.55114748845179,-19.44885251154821,2.0211842523576564,1.5760433975632808,0.06074016679261662,135237300.0,-1.0
222,ABBV,2021-01-19,95.75274658203125,95.8637074844116,94.11390634661629,94.95893232547522,7723800.0,1.41693115234375,0.0,1.41693115234375,77.01059886620345,87.62622163493238,96.18805334388634,94.91572858878031,-5.084271411219686,2.1766277726734558,1.696160272585316,0.06565314527419219,142961100.0,1.0
223,ABBV,2021-01-20,96.12830352783203,96.53801027497857,95.14670440652928,96.3758376723116,6554600.0,0.37555694580078125,0.0,0.37555694580078125,78.23114407516405,87.62622163493238,96.53801027497857,95.40264290710984,-4.597357092890164,2.3035680891991177,1.8176418359080764,0.07915497949518624,149515700.0,1.0
224,ABBV,2021-01-21,94.96746826171875,96.23927593851802,94.54068655023973,96.1368459833811,5417000.0,-1.1608352661132812,1.1608352661132812,0.0,65.77629857364471,87.62622163493238,96.53801027497857,82.37680361715037,-17.62319638284962,2.2841690239355046,1.9109472735135622,0.05483364237362265,144098700.0,-1.0
225,ABBV,2021-01-22,94.62603759765625,95.25767268058716,93.4481224680545,94.4467900678585,5185500.0,-0.3414306640625,0.3414306640625,0.0,62.40455314909089,87.62622163493238,96.53801027497857,78.54557873230246,-21.454421267697544,2.215703276283648,1.9718984740675793,0.0455543792937001,138913200.0,-1.0
226,ABBV,2021-01-25,94.31875610351562,94.94186025353704,93.21765853134427,93.66151514805946,6928200.0,-0.307281494140625,0.307281494140625,0.0,59.250567931747035,87.89620979541802,96.53801027497857,74.31953935164447,-25.680460648355545,2.1122993578578217,1.9999786508256279,0.025430324467705212,131985000.0,-1.0
227,ABBV,2021-01-26,92.86771392822266,95.00162273620413,92.66285399389196,95.00162273620413,5554600.0,-1.4510421752929688,1.4510421752929688,0.0,46.45712948165752,87.89620979541802,96.53801027497857,57.52856878104462,-42.47143121895538,1.8914604546515221,1.978275011590807,0.002664743109291434,126430400.0,-1.0
228,ABBV,2021-01-27,87.73778533935547,91.07521494866141,87.56706874685345,90.71671987266537,11887900.0,-5.1299285888671875,5.1299285888671875,0.0,24.70081733297195,87.56706874685345,96.53801027497857,1.9029952649540518,-98.09700473504594,1.2876583528298937,1.8401516798386246,-0.07521365239465261,114542500.0,-1.0
229,ABBV,2021-01-28,88.94983673095703,89.7436509141629,88.01091833985274,88.77058920728751,8534300.0,1.2120513916015625,0.0,1.2120513916015625,33.225899569397015,87.56706874685345,96.53801027497857,15.413855722595162,-84.58614427740484,0.8966077173047609,1.651442887331852,-0.06646953803792766,123076800.0,1.0
230,ABBV,2021-01-29,87.47318267822266,89.18884047407877,86.9012902340985,88.77059621914675,9380400.0,-1.476654052734375,1.476654052734375,0.0,28.66395447340051,86.9012902340985,96.53801027497857,5.9345134205219825,-94.06548657947802,0.4622154997244792,1.4135974098103776,-0.07274684296951728,113696400.0,-1.0
231,ABBV,2021-02-01,87.31954193115234,88.67670466580617,86.94397193617645,87.91703373027562,7518200.0,-0.1536407470703125,0.1536407470703125,0.0,28.199134648553468,86.9012902340985,96.53801027497857,4.340187276164247,-95.65981272383576,0.10435606194512559,1.1517491402373272,-0.08807271803586536,106178200.0,-1.0
232,ABBV,2021-02-02,88.3182144165039,89.03520461466444,87.49025679802861,87.81460857640991,10481300.0,0.9986724853515625,0.0,0.9986724853515625,35.984807872727814,86.9012902340985,96.53801027497857,14.703386384523508,-85.29661361547649,-0.09754120430037005,0.9018910713297877,-0.08124650934952649,116659500.0,1.0
233,ABBV,2021-02-03,91.28860473632812,91.81781639863004,88.7791327215652,90.64843217432815,12101900.0,2.9703903198242188,0.0,2.9703903198242188,53.346413069614535,86.9012902340985,96.53801027497857,45.527051565451046,-54.472948434548954,-0.017657032220583346,0.7179814506197135,-0.03873814467973524,128761400.0,1.0
234,ABBV,2021-02-04,92.63723754882812,92.93598344538727,89.83755055449313,91.22032564850245,9077800.0,1.3486328125,0.0,1.3486328125,59.150356857741,86.9012902340985,96.53801027497857,59.52178013262892,-40.478219867371074,0.1527147447228714,0.6049281094403451,-0.02101747150487665,137839200.0,1.0
235,ABBV,2021-02-05,92.80794525146484,94.12242707041462,92.56041110026297,93.57614705126961,7251000.0,0.17070770263671875,0.0,0.17070770263671875,59.87933347760179,86.9012902340985,96.53801027497857,61.29320964300753,-38.70679035699247,0.29807427545902954,0.5435573426440821,-0.016018138008442873,145090200.0,1.0
236,ABBV,2021-02-08,91.19470977783203,93.02134142996111,90.31554052503239,92.94451733826548,9199100.0,-1.6132354736328125,1.6132354736328125,0.0,50.12547620187322,86.9012902340985,96.53801027497857,44.55270595721733,-55.447294042782666,0.279871942363755,0.49082026258801664,-0.018014916913790868,135891100.0,-1.0
237,ABBV,2021-02-09,89.96558380126953,90.90450224028407,89.7180496334269,90.47772053962547,5506900.0,-1.2291259765625,1.2291259765625,0.0,43.84660022955406,86.9012902340985,96.23927593851802,32.815359373711104,-67.1846406262889,0.16437149689070907,0.42553050944855514,0.02539155112358138,130384200.0,-1.0
238,ABBV,2021-02-10,88.81327819824219,90.58868519742202,88.53160070119483,90.46065589164796,7446000.0,-1.1523056030273438,1.1523056030273438,0.0,38.614320301774214,86.9012902340985,95.25767268058716,22.880570347125555,-77.11942965287444,-0.019915298171085283,0.33644134792462704,-0.0015352308417145855,122938200.0,-1.0
239,ABBV,2021-02-11,88.55721282958984,89.35102714242873,88.19018026532729,89.25713463676813,5090100.0,-0.25606536865234375,0.25606536865234375,0.0,37.46789587642589,86.9012902340985,95.00162273620413,20.442649669762332,-79.55735033023768,-0.18449945116904587,0.23225318810589246,0.012392714180240683,117848100.0,-1.0
240,ABBV,2021-02-12,89.14617919921875,89.25714011627834,88.04508143883452,88.56575572503573,3738400.0,0.5889663696289062,0.0,0.5889663696289062,42.03509280273276,86.9012902340985,95.00162273620413,27.713540950778366,-72.28645904922163,-0.2643615196853375,0.13293024654764646,0.02091899737067604,121586500.0,1.0
241,ABBV,2021-02-16,88.94132232666016,90.63991853762977,88.78768062195368,89.90585333871813,5637300.0,-0.20485687255859375,0.20485687255859375,0.0,40.83802332841437,86.9012902340985,94.12242707041462,28.250843860236095,-71.7491561397639,-0.34026070814107356,0.038292055609902426,0.007055259373991651,115949200.0,-1.0
242,ABBV,2021-02-17,90.72525024414062,91.11788860796963,88.89862517615833,89.36808111648425,6940400.0,1.7839279174804688,0.0,1.7839279174804688,54.00044138940985,86.9012902340985,94.12242707041462,52.955096915085335,-47.044903084914665,-0.2535406302211243,-0.020074481556302932,-0.0061711370637622665,122889600.0,1.0
243,ABBV,2021-02-18,90.5289306640625,90.99839313138057,89.80340308816608,89.89729558162969,5386600.0,-0.196319580078125,0.196319580078125,0.0,52.516811492213634,86.9012902340985,94.12242707041462,50.23641723170355,-49.76358276829645,-0.19836901842218424,-0.05573338892947921,-0.022758740875173045,117503000.0,-1.0
244,ABBV,2021-02-19,89.6326904296875,91.07520808258984,89.54733539595739,90.67403877284114,6702400.0,-0.896240234375,0.896240234375,0.0,45.877317132068555,86.94397193617645,94.12242707041462,37.455391769282066,-62.544608230717934,-0.22437772809071532,-0.08946225676172644,-0.03421317876582586,110800600.0,-1.0
245,ABBV,2021-02-22,91.38248443603516,91.91169602422731,88.96690525627905,89.3339377342474,10272500.0,1.7497940063476562,0.0,1.7497940063476562,57.87477609142006,87.49025679802861,94.12242707041462,58.6870885117711,-41.312911488228906,-0.10261320484323733,-0.09209244637802863,0.0020590520948045032,121073100.0,1.0
246,ABBV,2021-02-23,90.70818328857422,91.84342421900027,90.44358070786296,91.3056815998274,7058600.0,-0.6743011474609375,0.6743011474609375,0.0,52.68213610466435,88.04508143883452,94.12242707041462,43.82014799193346,-56.17985200806655,-0.05983467299445522,-0.08564089170131396,0.008254261862459034,114014500.0,-1.0
247,ABBV,2021-02-24,92.77381134033203,93.41398391317523,90.1362969538885,90.47772362850598,7626200.0,2.0656280517578125,0.0,2.0656280517578125,64.07517702321371,88.04508143883452,94.12242707041462,77.8091322784953,-22.19086772150471,0.1391425923134051,-0.04068419489837014,0.04459393034957504,121640700.0,1.0
248,ABBV,2021-02-25,91.61296081542969,93.29448174675986,91.39103250915888,92.59456002283365,6237600.0,-1.1608505249023438,1.1608505249023438,0.0,55.42211687852862,88.04508143883452,94.12242707041462,58.70785689816902,-41.29214310183097,0.20084733029975155,0.007622110141254209,0.034505918695973525,115403100.0,-1.0
249,ABBV,2021-02-26,91.9629135131836,92.67991011357199,89.93143508439765,91.91170179607425,9250000.0,0.34995269775390625,0.0,0.34995269775390625,57.422182540943965,88.04508143883452,93.41398391317523,72.97268097294274,-27.027319027057256,0.27481909417618056,0.061061506948239495,0.03159680357887429,124653100.0,1.0
250,ABBV,2021-03-01,92.5348129272461,93.21765975180453,92.24459797987542,92.63723636923524,4709500.0,0.5718994140625,0.0,0.5718994140625,60.74338868840665,88.04508143883452,93.41398391317523,83.62475403248789,-16.37524596751211,0.37526394380783756,0.12390199432015914,0.04040293652693738,129362600.0,1.0
251,ABBV,2021-03-02,92.05680084228516,93.36275165273852,92.0226575287357,92.91036414450787,5487000.0,-0.4780120849609375,0.4780120849609375,0.0,56.493495489796814,88.04508143883452,93.41398391317523,74.72140577378002,-25.27859422621998,0.4115515208431617,0.18143189962475967,0.014676736570704785,123875600.0,-1.0
252,ABBV,2021-03-03,91.08374786376953,91.45078037912894,90.01679363448889,91.21178367371758,7218700.0,-0.973052978515625,0.973052978515625,0.0,48.52005430723281,88.04508143883452,93.41398391317523,56.59753440219,-43.40246559781,0.3576694532935676,0.21667941035852126,0.006128617621319998,116656900.0,-1.0
253,ABBV,2021-03-04,90.17897033691406,91.97145209148312,89.58147207727662,90.90449789088586,7503700.0,-0.9047775268554688,0.9047775268554688,0.0,42.139097523470845,88.04508143883452,93.41398391317523,39.74534661931222,-60.254653380687785,0.23920216820754092,0.2211839619283252,0.0060946503402694585,109153200.0,-1.0
254,ABBV,2021-03-05,91.0752182006836,91.32275238452112,88.83034865454452,90.48626384399519,7277800.0,0.8962478637695312,0.0,0.8962478637695312,49.69989570813432,88.78768062195368,93.41398391317523,49.446338355518854,-50.55366164448115,0.21515552446091135,0.21997827443484244,-0.003362419365678715,116431000.0,1.0
255,ABBV,2021-03-08,90.57161712646484,92.32142478308434,90.30701454399767,91.20325224856659,6049400.0,-0.50360107421875,0.50360107421875,0.0,45.81815550496306,88.83034865454452,93.41398391317523,37.988809616594565,-62.011190383405435,0.15369034164015716,0.2067206878759054,-0.0015055550354802216,110381600.0,-1.0
256,ABBV,2021-03-09,91.15204620361328,92.77381814283113,90.85330028348247,90.88744360466494,6857500.0,0.5804290771484375,0.0,0.5804290771484375,50.91636976707684,88.83034865454452,93.41398391317523,50.65188257938158,-49.34811742061843,0.15008443702302543,0.19539343770532944,-0.017480850611703902,117239100.0,1.0
257,ABBV,2021-03-10,92.18485260009766,92.49213596307177,91.37396992746574,91.66417837462332,5762600.0,1.032806396484375,0.0,1.032806396484375,58.863484220444896,88.83034865454452,93.41398391317523,73.18435600295217,-26.81564399704784,0.22793804819009722,0.201902359802283,0.006242476823995924,123001700.0,1.0
258,ABBV,2021-03-11,92.07389068603516,92.72259421215625,91.62149659227217,92.2958124918371,4671400.0,-0.1109619140625,0.1109619140625,0.0,57.70526397665526,88.83034865454452,93.41398391317523,70.76352825812745,-29.23647174187255,0.27748521995626163,0.21701893183307874,0.0012067600798191247,118330300.0,-1.0
259,ABBV,2021-03-12,92.37263488769531,92.67991824164329,91.64710727894062,92.01413981214671,5341200.0,0.29874420166015625,0.0,0.29874420166015625,60.14160694058135,88.83034865454452,93.41398391317523,77.28115422100569,-22.718845778994307,0.3369734506850932,0.24100983560348163,-0.001752616495570014,123671500.0,1.0
260,ABBV,2021-03-15,94.1139144897461,94.19926953836027,92.49214251738553,92.75674512174132,6642200.0,1.7412796020507812,0.0,1.7412796020507812,71.27133373977948,88.83034865454452,94.19926953836027,98.4102010355289,-1.589798964471105,0.5186463806531663,0.29653714461341857,0.022346134436990184,130313700.0,1.0
261,ABBV,2021-03-16,94.60897064208984,94.81383056095414,93.80662541914137,93.84929968477547,5570200.0,0.49505615234375,0.0,0.49505615234375,73.68207306016535,88.83034865454452,94.81383056095414,96.57624236074231,-3.423757639257688,0.6945638805394765,0.3761424917986302,0.03870309315326881,135883900.0,1.0
262,ABBV,2021-03-17,89.6583023071289,89.70097657077275,87.74632207210699,88.56574217283067,19445600.0,-4.9506683349609375,4.9506683349609375,0.0,37.435128973060145,87.74632207210699,94.81383056095414,27.053101358691052,-72.94689864130895,0.42955061494001257,0.38682411642690673,-0.005773718948441142,116438300.0,-1.0
263,ABBV,2021-03-18,88.57427978515625,89.61562827659432,88.27553386847465,88.77060225164563,8675100.0,-1.0840225219726562,1.0840225219726562,0.0,33.2967200979778,87.74632207210699,94.81383056095414,11.714987174841218,-88.28501282515879,0.13054924436555382,0.33556914201463617,-0.027460141901790913,107763200.0,-1.0
264,ABBV,2021-03-19,88.27552795410156,89.13762883777078,87.84874624110107,88.71084712477027,10899100.0,-0.2987518310546875,0.2987518310546875,0.0,32.16595928821373,87.74632207210699,94.81383056095414,7.487870482641536,-92.51212951735846,-0.12903088424671694,0.24264913676236555,-0.02535108950475362,96864100.0,-1.0
265,ABBV,2021-03-22,90.39237213134766,90.81915386330665,87.81460682349883,88.34381851551005,7627200.0,2.1168441772460938,0.0,2.1168441772460938,46.90712311695805,87.74632207210699,94.81383056095414,37.43964458502244,-62.56035541497755,-0.1620701290845119,0.16170528359299005,-0.008334141732470601,104491300.0,1.0
266,ABBV,2021-03-23,89.48758697509766,90.42651195888189,89.20591599213456,89.9399810637265,6111600.0,-0.90478515625,0.90478515625,0.0,42.36654060555433,87.74632207210699,94.81383056095414,24.63760610600552,-75.36239389399448,-0.25828521786171166,0.07770718330204969,-0.02925931483234956,98379700.0,-1.0
267,ABBV,2021-03-24,87.9682388305664,89.90583132733236,87.95970788562981,89.4705121852131,9420100.0,-1.51934814453125,1.51934814453125,0.0,35.67538431622759,87.74632207210699,94.81383056095414,3.1399574377534782,-96.86004256224652,-0.4519255498989594,-0.028219363338152156,-0.04459083704270417,88959600.0,-1.0
268,ABBV,2021-03-25,88.66815948486328,88.89862523885975,87.10614348544681,87.83167103895066,6281500.0,0.699920654296875,0.0,0.699920654296875,40.657178468049516,87.10614348544681,94.81383056095414,20.26569039602141,-79.73430960397859,-0.5426537858191125,-0.13110624783434427,-0.04010360219058229,95241100.0,1.0
269,ABBV,2021-03-26,90.46063232421875,90.58013065325682,88.63400105427147,88.65961342092578,6596900.0,1.7924728393554688,0.0,1.7924728393554688,51.708846652021336,87.10614348544681,94.81383056095414,43.5213418229118,-56.47865817708819,-0.4645637866062202,-0.19779775558871948,-0.038817662460797764,101838000.0,1.0
270,ABBV,2021-03-29,91.100830078125,91.33128934476062,90.04240670910389,90.27287248791184,5472700.0,0.64019775390625,0.0,0.64019775390625,55.15093864379018,87.10614348544681,94.81383056095414,51.827306344234955,-48.17269365576504,-0.3470180828318803,-0.22764182103735167,-0.03708042208001927,107310700.0,1.0
271,ABBV,2021-03-30,91.15204620361328,91.35689961853546,90.36676935293438,91.21179538763946,5354100.0,0.05121612548828125,0.0,0.05121612548828125,55.44409589248647,87.10614348544681,94.81383056095414,52.491787465309926,-47.508212534690074,-0.24688363160191784,-0.23149018315026493,0.016660407993980053,112664800.0,1.0
272,ABBV,2021-03-31,92.37263488769531,93.19205499416589,91.16057638721834,91.2288565119618,9048000.0,1.2205886840820312,0.0,1.2205886840820312,62.2326106931575,87.10614348544681,94.81383056095414,68.32777914640305,-31.672220853596954,-0.06824832748513643,-0.19884181201723924,0.04288327392277158,121712800.0,1.0
273,ABBV,2021-04-01,92.62870025634766,93.02134516357945,91.60442674855484,92.9701269296693,5091700.0,0.25606536865234375,0.0,0.25606536865234375,63.575954276308934,87.10614348544681,94.81383056095414,71.6499867833223,-28.350013216677695,0.09291273308269865,-0.14049090299725167,0.049313466632672,126804500.0,1.0
274,ABBV,2021-04-05,90.59722900390625,93.10670776768795,89.96559383986018,93.10670776768795,10584400.0,-2.0314712524414062,2.0314712524414062,0.0,47.960311205749555,87.10614348544681,94.81383056095414,45.293555437052454,-54.70644456294755,0.05606500000311598,-0.10117972239717814,0.002266307075788676,116220100.0,-1.0
275,ABBV,2021-04-06,89.9485092163086,90.71671758274584,89.52172751408479,90.3496850583465,8522500.0,-0.6487197875976562,0.6487197875976562,0.0,43.98000375859393,87.10614348544681,93.19205499416589,46.704026616056204,-53.295973383943796,-0.025192950536862213,-0.08598236802511496,0.005150683539373979,107697600.0,-1.0
276,ABBV,2021-04-07,89.80339813232422,90.58867484143693,88.91569147812972,90.07653814037087,8037300.0,-0.145111083984375,0.145111083984375,0.0,43.057694129369,87.10614348544681,93.19205499416589,44.31964945617671,-55.68035054382329,-0.10014530080943018,-0.08881495458197801,0.02086161239731621,99660300.0,-1.0
277,ABBV,2021-04-08,90.5630874633789,91.2630092838342,89.9229148283708,89.96559560890714,5881800.0,0.7596893310546875,0.0,0.7596893310546875,49.46004772217199,87.10614348544681,93.19205499416589,56.80240294291911,-43.19759705708089,-0.09712539728269576,-0.09047704312212157,0.021371008370136613,105542100.0,1.0
278,ABBV,2021-04-09,91.7922134399414,91.94585512016539,90.52040573330373,90.81061417807555,5977500.0,1.2291259765625,0.0,1.2291259765625,58.227999578088856,87.10614348544681,93.19205499416589,76.99865415034421,-23.00134584965579,0.004397401542505008,-0.07150215418919625,0.014720006720162493,111519600.0,1.0
279,ABBV,2021-04-12,92.39824676513672,92.67138681841281,91.6385757884572,92.0312142080308,5647500.0,0.6060333251953125,0.0,0.6060333251953125,61.980476376694085,87.10614348544681,93.19205499416589,86.9566255130081,-13.04337448699189,0.13223248179657787,-0.030755226992041418,0.014241546272400596,117167100.0,1.0
280,ABBV,2021-04-13,92.37263488769531,92.49213324621151,91.35689232813547,92.21045575306384,6165100.0,-0.02561187744140625,0.02561187744140625,0.0,61.710153881936186,87.10614348544681,93.19205499416589,86.53578670513664,-13.464213294863365,0.22883813585467294,0.02116344557730147,0.013390688798751826,111002000.0,-1.0
281,ABBV,2021-04-14,91.49140930175781,92.15664137934708,91.21494827594331,91.7678703275723,7766700.0,-0.8812255859375,0.8812255859375,0.0,52.60212934814605,87.10614348544681,93.19205499416589,72.05602332581378,-27.943976674186217,0.23162128663739168,0.06325501378931953,-0.009539898769899469,103235300.0,-1.0
282,ABBV,2021-04-15,92.34671783447266,92.39855222165436,91.2495148939014,91.56916906999037,5730500.0,0.8553085327148438,0.0,0.8553085327148438,59.32531858707769,88.63400105427147,93.19205499416589,81.45398955693774,-18.546010443062258,0.2993919995346346,0.11048241093838256,-0.0030442230226119804,108965800.0,1.0
283,ABBV,2021-04-16,93.22792053222656,93.78084250622301,92.56268195668873,92.86506013131964,8207700.0,0.8812026977539062,0.0,0.8812026977539062,65.19435854553602,88.91569147812972,93.78084250622301,88.63505015972456,-11.364949840275434,0.41937220915914963,0.172260370582536,0.029037218436414713,117173500.0,1.0
284,ABBV,2021-04-19,93.83269500732422,93.93637036923191,92.54542390588823,93.27977292651877,4542900.0,0.6047744750976562,0.0,0.6047744750976562,68.76355202471092,88.91569147812972,93.93637036923191,97.93503300736027,-2.064966992639725,0.5568387450792613,0.24917604548188113,0.043182325364336194,121716400.0,1.0
285,ABBV,2021-04-20,94.19554138183594,94.65342932558102,93.34888239677726,93.40935803856716,5411800.0,0.36284637451171875,0.0,0.36284637451171875,70.8340455806381,88.91569147812972,94.65342932558102,92.01971306603923,-7.9802869339607705,0.6871397162508259,0.33676877963567015,0.048908430425315785,127128200.0,1.0
286,ABBV,2021-04-21,95.72472381591797,96.27764586581931,94.47200464711746,94.85214102818117,6181100.0,1.5291824340820312,0.0,1.5291824340820312,77.9434626615668,88.91569147812972,96.27764586581931,92.4894665087043,-7.510533491295705,0.9033827827781664,0.4500915802641694,0.05699492472168943,133309300.0,1.0
287,ABBV,2021-04-22,95.07677459716797,95.97526805020053,94.69663818841103,95.59513823279482,5046000.0,-0.64794921875,0.64794921875,0.0,69.64363955470878,88.91569147812972,96.27764586581931,83.68814576385591,-16.31185423614409,1.0108207715035036,0.5622374185120362,0.03578256841333949,128263300.0,-1.0
288,ABBV,2021-04-23,96.22579193115234,96.56272855394828,94.64478415932138,94.7830113575031,4611000.0,1.149017333984375,0.0,1.149017333984375,75.07447836984596,88.91569147812972,96.56272855394828,95.5938931712337,-4.406106828766294,1.1751360112706237,0.6848171370637538,0.04142443498678827,132874300.0,1.0
289,ABBV,2021-04-26,96.23444366455078,96.7960069607786,95.76791446113154,96.38131213840019,5202300.0,0.0086517333984375,0.0,0.0086517333984375,75.11316059178023,88.91569147812972,96.7960069607786,92.87384753231918,-7.126152467680819,1.2911713258738615,0.8060879748257753,0.04180684876587715,138076600.0,1.0
290,ABBV,2021-04-27,96.27765655517578,96.6318691930251,95.53466623225108,96.11350553760941,3522900.0,0.043212890625,0.0,0.043212890625,75.33377201413799,89.9229148283708,96.7960069607786,92.45826484474568,-7.541735155254317,1.3708151639065136,0.9190334126419231,0.05231362474297363,141599500.0,1.0
291,ABBV,2021-04-28,96.70097351074219,97.25389555002161,96.17396866215545,96.48498813316895,5116000.0,0.42331695556640625,0.0,0.42331695556640625,77.58018935081449,90.52040573330373,97.25389555002161,91.78847738201623,-8.211522617983778,1.4513612310207833,1.0254989763176952,0.04715116875159908,146715500.0,1.0
292,ABBV,2021-04-29,95.80247497558594,97.28845545003232,95.31866983185019,97.08974599951186,6766700.0,-0.89849853515625,0.89849853515625,0.0,63.432136957459974,91.21494827594331,97.28845545003232,75.53340381672852,-24.46659618327147,1.426252298119195,1.1056496406779952,0.02761570169817751,139948800.0,-1.0
293,ABBV,2021-04-30,96.3294906616211,97.02928126481834,95.128612336735,96.30357346762882,10575400.0,0.5270156860351562,0.0,0.5270156860351562,67.44963572655556,91.21494827594331,97.28845545003232,84.21069143538037,-15.789308564619631,1.432367607140307,1.1709932339704576,0.026609015696522187,150524200.0,1.0
294,ABBV,2021-05-03,99.07682037353516,99.43967425416888,96.40723747149879,97.10703463140798,9138200.0,2.7473297119140625,0.0,2.7473297119140625,80.40117440661986,91.21494827594331,99.43967425416888,95.58825568664105,-4.41174431335894,1.6399957310031397,1.264793733376994,0.05182070106601122,159662400.0,1.0
295,ABBV,2021-05-04,98.4029541015625,100.1653958378971,97.66860502592766,99.02499313689843,8151400.0,-0.6738662719726562,0.6738662719726562,0.0,72.2635835292503,91.2495148939014,100.1653958378971,80.23255640799586,-19.767443592004142,1.730222213980511,1.3578794294976977,0.02797845926194431,151511000.0,-1.0
296,ABBV,2021-05-05,100.02714538574219,100.45911613388677,98.44613086560891,98.75715033158104,7021400.0,1.6241912841796875,0.0,1.6241912841796875,78.35592078205426,92.54542390588823,100.45911613388677,94.54147652323056,-5.458523476769442,1.9107599630253134,1.468455536203221,0.05206708798808668,158532400.0,1.0
297,ABBV,2021-05-06,100.28634643554688,100.37273928065838,98.62758008054021,99.35328788909878,5803800.0,0.2592010498046875,0.0,0.2592010498046875,79.19731675730009,92.54542390588823,100.45911613388677,97.8168256565673,-2.1831743434326962,2.0511088819108494,1.584986205344747,0.04219819263529456,164336200.0,1.0
298,ABBV,2021-05-07,100.00123596191406,101.02068727036342,99.3187213358771,100.54551677396078,6808200.0,-0.2851104736328125,0.2851104736328125,0.0,75.4735667905911,93.34888239677726,101.02068727036342,86.71171484093257,-13.288285159067422,2.1149505454571056,1.6909790733672188,0.03914183065777754,157528000.0,-1.0
299,ABBV,2021-05-10,100.40728759765625,101.25394662214403,100.1913022110123,100.5455148176059,7093300.0,0.4060516357421875,0.0,0.4060516357421875,77.23269566436016,94.47200464711746,101.25394662214403,87.5159795290867,-12.484020470913288,2.1732585257791754,1.78743496384961,0.042892932693203045,164621300.0,1.0
300,ABBV,2021-05-11,99.25824737548828,100.70966949027556,98.81763532510165,99.76797633404362,5784600.0,-1.1490402221679688,1.1490402221679688,0.0,62.577726286606314,94.64478415932138,101.25394662214403,69.80405220961356,-30.195947790386434,2.102513609161548,1.8504506929119977,0.026445171872670148,158836700.0,-1.0
301,ABBV,2021-05-12,99.31871032714844,100.21721024443994,98.86946366417784,99.22367623840172,6208300.0,0.06046295166015625,0.0,0.06046295166015625,63.00395338722541,94.64478415932138,101.25394662214403,70.71888751590643,-29.28111248409358,2.027949666539854,1.885950487637569,0.03670296986021038,165045000.0,1.0
302,ABBV,2021-05-13,100.7355728149414,101.25393637214242,99.36190905879118,99.82843823767718,6558200.0,1.4168624877929688,0.0,1.4168624877929688,71.71473928588026,95.128612336735,101.25394662214403,91.53721604325457,-8.462783956745419,2.059446153059099,1.920649620721875,0.04573970154994034,171603200.0,1.0
303,ABBV,2021-05-14,100.5887222290039,101.5908910722201,100.5455225118289,101.39218819245849,6268500.0,-0.1468505859375,0.1468505859375,0.0,69.75071623259662,95.128612336735,101.5908910722201,84.49202078342466,-15.507979216575334,2.0489388390262775,1.9463074643827558,0.01525989479444978,165334700.0,-1.0
304,ABBV,2021-05-17,100.98613739013672,101.69456926860178,100.70103506809122,100.88246202084247,6183200.0,0.3974151611328125,0.0,0.3974151611328125,72.13376589324676,95.128612336735,101.69456926860178,89.21053114090945,-10.78946885909055,2.049059516507313,1.9668578748076677,0.026251074595871282,171517900.0,1.0
305,ABBV,2021-05-18,101.2625961303711,101.85871795529096,99.6297470016659,100.3122616700093,8174900.0,0.276458740234375,0.0,0.276458740234375,73.79106598519621,95.128612336735,101.85871795529096,91.14245958820823,-8.857540411791774,2.047856647468336,1.9830576293398017,0.012351154677708198,179692800.0,1.0
306,ABBV,2021-05-19,100.08763885498047,100.64920224586724,98.8176435746009,100.61464378889787,6433600.0,-1.174957275390625,1.174957275390625,0.0,57.1292880547283,95.128612336735,101.85871795529096,73.68423022326209,-26.31576977673791,1.9298480455169909,1.97241571257524,-0.00198140213128728,173259200.0,-1.0
307,ABBV,2021-05-20,101.17620086669922,101.374903742685,99.45695893569668,99.64702055014139,5526100.0,1.08856201171875,0.0,1.08856201171875,65.4652060432247,96.40723747149879,101.85871795529096,87.48015166483796,-12.519848335162042,1.9022354489584785,1.958379659851888,0.011749503828459185,178785300.0,1.0
308,ABBV,2021-05-21,100.32090759277344,102.18701814455882,100.26906661122958,101.53042063960112,5577800.0,-0.8552932739257812,0.8552932739257812,0.0,55.65445105255114,97.66860502592766,102.18701814455882,58.69986867533893,-41.30013132466107,1.7906952281084898,1.9248427735032088,-0.0008602961692277811,173207500.0,-1.0
309,ABBV,2021-05-24,100.13948059082031,100.91702280876018,99.86301293298175,100.72695458967203,4821300.0,-0.181427001953125,0.181427001953125,0.0,53.685286803086875,98.44613086560891,102.18701814455882,45.26599170041653,-54.73400829958347,1.668426573690553,1.8735595335406778,0.008878186333457716,168386200.0,-1.0
310,ABBV,2021-05-25,98.97315216064453,100.21723023136992,98.6534979723371,100.19131303678842,6574200.0,-1.1663284301757812,1.1663284301757812,0.0,42.524636638852364,98.62758008054021,102.18701814455882,9.708613379106461,-90.29138662089355,1.4605781910597102,1.7909632650444844,-0.0034792856790595295,161812000.0,-1.0
311,ABBV,2021-05-26,99.09407806396484,99.12863651166633,98.28197761270465,98.94720960474598,5802600.0,0.1209259033203125,0.0,0.1209259033203125,43.91937719870065,98.28197761270465,102.18701814455882,20.796210554941304,-79.20378944505869,1.290735761729593,1.6909177643815063,-0.01629508529218482,167614600.0,1.0
312,ABBV,2021-05-27,97.03791809082031,99.52606747061273,96.77873298004248,99.45695715357631,26406000.0,-2.0561599731445312,2.0561599731445312,0.0,29.753682082730904,96.77873298004248,102.18701814455882,4.792371387484224,-95.20762861251578,0.9789349344962233,1.5485211984044498,-0.03530022113313758,141208600.0,-1.0
313,ABBV,2021-05-28,97.79817199707031,98.90402261800091,97.50443506042885,97.91048860689823,7104300.0,0.76025390625,0.0,0.76025390625,38.250646488081344,96.77873298004248,102.18701814455882,18.84957959902624,-81.15042040097376,0.7841376186763398,1.3956444824588279,-0.031568346660794,148312900.0,1.0
314,ABBV,2021-06-01,96.94288635253906,98.48070134921447,96.79601786214901,98.23015749371604,6846200.0,-0.85528564453125,0.85528564453125,0.0,33.059772110392885,96.77873298004248,102.18701814455882,3.0352203610414725,-96.96477963895853,0.5543546831453483,1.227386522596132,-0.042658493292731636,141466700.0,-1.0
315,ABBV,2021-06-02,96.24308776855469,97.33165594202661,95.76791729047348,97.11567055950802,8100700.0,-0.699798583984375,0.699798583984375,0.0,29.305232474584514,95.76791729047348,102.18701814455882,7.4024460572043385,-92.59755394279566,0.3121834969497428,1.0443459174668541,-0.03841184716122892,133366000.0,-1.0
316,ABBV,2021-06-03,96.94288635253906,97.1156786277197,95.5951395628867,96.00119317037205,6286100.0,0.699798583984375,0.0,0.699798583984375,37.49579917419898,95.5951395628867,102.18701814455882,20.44556453754474,-79.55443546245526,0.1747149788857314,0.8704197297506295,-0.04184101080982072,139652100.0,1.0
317,ABBV,2021-06-04,97.07247924804688,97.72043545168299,96.89969356361779,97.10703770320296,4255400.0,0.1295928955078125,0.0,0.1295928955078125,39.00577990112086,95.5951395628867,102.18701814455882,22.41151239144073,-77.58848760855926,0.07535856489997173,0.711407496780498,-0.03238037237374991,143907500.0,1.0
318,ABBV,2021-06-07,97.634033203125,98.58436755862975,97.04655270477376,97.37484811010064,5570100.0,0.561553955078125,0.0,0.561553955078125,45.57911808680553,95.5951395628867,102.18701814455882,30.930388279711103,-69.0696117202889,0.04145276044467039,0.5774165495133324,-0.025019576423936263,149477600.0,1.0
319,ABBV,2021-06-08,97.0551986694336,97.70315488605245,96.60595192610585,97.34894224847025,4114200.0,-0.5788345336914062,0.5788345336914062,0.0,40.40070081504766,95.5951395628867,102.18701814455882,22.14936286306004,-77.85063713693997,-0.031758846991337464,0.4555814702123984,-0.01937852285534858,145363400.0,-1.0
320,ABBV,2021-06-09,98.48934173583984,98.85219562346863,97.4007734816022,97.52172477747847,4884000.0,1.43414306640625,0.0,1.43414306640625,55.01263308520429,95.5951395628867,102.18701814455882,43.90557467184096,-56.09442532815903,0.02564813079141004,0.36959480232820074,-0.006102648512806619,150247400.0,1.0
321,ABBV,2021-06-10,100.42455291748047,101.07250900894893,98.61891843976979,98.80034535441894,6263800.0,1.935211181640625,0.0,1.935211181640625,67.4411508402567,95.5951395628867,102.18701814455882,73.26308114990677,-26.736918850093232,0.22470864205112662,0.34061757027278594,0.03490011835878959,156511200.0,1.0
322,ABBV,2021-06-11,99.71613311767578,100.52824029204086,99.24096921522785,100.42456493211628,4471400.0,-0.7084197998046875,0.7084197998046875,0.0,60.393720673844996,95.5951395628867,101.07250900894893,75.236728056599,-24.763271943400994,0.32159482904248193,0.3368130220267252,0.019611420964626314,152039800.0,-1.0
323,ABBV,2021-06-14,99.69886016845703,99.76797707714056,98.65349164218586,99.41375786365093,4427600.0,-0.01727294921875,0.01727294921875,0.0,60.2166908626249,95.5951395628867,101.07250900894893,74.92137687591193,-25.07862312408806,0.3924600128838591,0.347942420198152,0.028428840109997244,147612200.0,-1.0
324,ABBV,2021-06-15,100.07035064697266,100.16538474414307,98.93858274194795,99.66429706658104,3590500.0,0.371490478515625,0.0,0.371490478515625,62.914364705147015,95.5951395628867,101.07250900894893,81.70365589093612,-18.296344109063874,0.47314325762215503,0.37298258768295267,0.03976662602120329,151202700.0,1.0
325,ABBV,2021-06-16,99.81114959716797,100.67509100331169,99.50013016364824,100.40727127663908,6670200.0,-0.2592010498046875,0.2592010498046875,0.0,59.657565104388816,95.5951395628867,101.07250900894893,76.97143812915941,-23.028561870840587,0.510287673229243,0.4004436047922108,0.029587145096941825,144532500.0,-1.0
326,ABBV,2021-06-17,99.2668685913086,100.12216873528946,98.5152371972952,99.33598548552013,4172300.0,-0.544281005859375,0.544281005859375,0.0,53.00903760471274,95.5951395628867,101.07250900894893,67.03453299213842,-32.96546700786157,0.49015575139203804,0.4183860341121763,0.022605679387815547,140360200.0,-1.0
327,ABBV,2021-06-18,97.72908020019531,98.66213215729475,97.66860454935228,98.17832695055048,7415400.0,-1.5377883911132812,1.5377883911132812,0.0,38.8825070998685,95.5951395628867,101.07250900894893,38.95922410058971,-61.04077589941029,0.34612447942183167,0.40393372317410736,0.000973502721869135,132944800.0,-1.0
328,ABBV,2021-06-21,99.1200180053711,99.56926471604295,97.42668674863995,98.22151799267635,4666100.0,1.3909378051757812,0.0,1.3909378051757812,52.182022947109445,95.5951395628867,101.07250900894893,64.3534907987353,-35.646509201264706,0.34029302880949786,0.3912055843011855,0.021274690735219703,137610900.0,1.0
329,ABBV,2021-06-22,99.09407806396484,99.59516566861153,98.38564636445918,98.91265115704448,4359900.0,-0.02593994140625,0.02593994140625,0.0,51.938818477171594,95.5951395628867,101.07250900894893,63.87990687014163,-36.12009312985836,0.329776962162768,0.3789198598735021,0.0061401195039658685,133251000.0,-1.0
330,ABBV,2021-06-23,98.48934173583984,99.37920052322289,98.44614201959064,98.96451224917607,3837300.0,-0.604736328125,0.604736328125,0.0,46.152635989688484,96.60595192610585,101.07250900894893,42.166478000884986,-57.833521999115014,0.26953866198078913,0.3570436202949595,-0.019270299198949847,129413700.0,-1.0
331,ABBV,2021-06-24,99.1286392211914,100.3813582670492,98.71395102013857,98.8521782233728,7712300.0,0.6392974853515625,0.0,0.6392974853515625,52.5945272134553,96.60595192610585,101.07250900894893,56.479459420225375,-43.52054057977462,0.2702698368860581,0.33968886361317924,-0.005891663446185524,137126000.0,1.0
332,ABBV,2021-06-25,97.60812377929688,98.13512208537456,96.88240941589012,97.53900687014361,11709400.0,-1.5205154418945312,1.5205154418945312,0.0,39.59505691110125,96.60595192610585,101.07250900894893,22.43723374857488,-77.56276625142512,0.14646801745200833,0.30104469438094505,-0.02097051446353071,125416600.0,-1.0
333,ABBV,2021-06-28,97.62539672851562,98.58437239182948,97.48716291443205,97.8500233807259,5141800.0,0.01727294921875,0.0,0.01727294921875,39.79012059684076,96.88240941589012,101.07250900894893,17.73197262080149,-82.2680273791985,0.049181037862112476,0.25067196307717854,-0.024432350867664265,130558400.0,1.0
334,ABBV,2021-06-29,97.0206298828125,97.40940090843463,96.42450815826491,97.32300807955754,5795100.0,-0.604766845703125,0.604766845703125,0.0,35.19820545816812,96.42450815826491,101.07250900894893,12.825335960509978,-87.17466403949003,-0.07584493142066151,0.1853685841776105,-0.02795799593149506,124763300.0,-1.0
335,ABBV,2021-06-30,97.31437683105469,97.55627941333786,96.44179400951808,96.94288169644808,5042600.0,0.2937469482421875,0.0,0.2937469482421875,39.134802223637,96.42450815826491,100.67509100331169,20.935215362917617,-79.06478463708238,-0.14950261596862902,0.1183943441483626,-0.01966911808503302,129805900.0,1.0
336,ABBV,2021-07-01,98.71398162841797,98.96452551527575,97.5303791128523,97.5822135062187,5306900.0,1.3996047973632812,0.0,1.3996047973632812,54.373057152565956,96.42450815826491,100.67509100331169,53.862577289159006,-46.137422710840994,-0.09385850901946924,0.07594377351479623,0.010077874734982784,135112800.0,1.0
337,ABBV,2021-07-02,99.50015258789062,99.77661363650836,98.39430839341972,98.93858922906831,5719500.0,0.7861709594726562,0.0,0.7861709594726562,60.743091506823795,96.42450815826491,100.67509100331169,72.35818102474516,-27.641818975254832,0.013521406399988223,0.06345930009183462,0.0038350939615339197,140832300.0,1.0
338,ABBV,2021-07-06,99.98394012451172,100.13080857912225,99.1545505883999,99.50012846322153,7172100.0,0.48378753662109375,0.0,0.48378753662109375,64.2836595359631,96.42450815826491,100.67509100331169,83.73985629746343,-16.26014370253657,0.13608961762528793,0.07798536359852529,0.008979972142961756,148004400.0,1.0
339,ABBV,2021-07-07,100.86517333984375,101.05524153051783,99.62109543095947,100.13946562056177,6695100.0,0.8812332153320312,0.0,0.8812332153320312,69.97510340701736,96.42450815826491,101.05524153051783,95.89550562740321,-4.104494372596795,0.3008657704618969,0.12256144497119963,0.024122728024481788,154699500.0,1.0
340,ABBV,2021-07-08,100.51959991455078,100.9170122440622,99.94076064708965,100.00987755431365,3948800.0,-0.34557342529296875,0.34557342529296875,0.0,65.26901634928541,96.42450815826491,101.05524153051783,88.43289878928067,-11.567101210719333,0.39896811530536525,0.17784277903803278,0.014031875190535503,150750700.0,-1.0
341,ABBV,2021-07-09,100.71831512451172,101.3662713361856,100.31226151057986,100.4764125267697,4823400.0,0.1987152099609375,0.0,0.1987152099609375,66.75260240914062,96.42450815826491,101.3662713361856,86.88815735709696,-13.111842642903051,0.4871342071845959,0.23970106466734542,0.03186406238324335,155574100.0,1.0
342,ABBV,2021-07-12,101.62543487548828,102.24747380155577,100.75285871825238,100.90836844976926,8148400.0,0.9071197509765625,0.0,0.9071197509765625,72.8592048546601,96.42450815826491,102.24747380155577,89.31748933150251,-10.682510668497489,0.6230216472567207,0.3163651811852205,0.04097333563822825,163722500.0,1.0
343,ABBV,2021-07-13,101.86734771728516,102.02285086308198,100.81333800899087,101.59088010337781,6540300.0,0.241912841796875,0.0,0.241912841796875,74.31108244563791,96.42450815826491,102.24747380155577,93.47195041913753,-6.528049580862466,0.7416840945532925,0.401428963858835,0.049955538737759486,170262800.0,1.0
344,ABBV,2021-07-14,102.52253723144531,102.6885182494398,101.67517027722845,102.09448828827576,6543400.0,0.6551895141601562,0.0,0.6551895141601562,77.99045976835527,96.42450815826491,102.6885182494398,97.35024344503648,-2.6497565549635187,0.8784668382136402,0.4968365387297961,0.05351892053352403,176806200.0,1.0
345,ABBV,2021-07-15,102.36527252197266,102.63607798778553,101.11606301041272,102.04204815015915,4544600.0,-0.15726470947265625,0.15726470947265625,0.0,75.01477067083721,96.42450815826491,102.6885182494398,94.8396359079538,-5.1603640920461995,0.9630764544202037,0.5900845218678777,0.036988588985286563,172261600.0,-1.0
346,ABBV,2021-07-16,102.64482879638672,103.36989599510413,102.13815485042758,103.00299693003019,6826100.0,0.2795562744140625,0.0,0.2795562744140625,76.82816546912505,96.42450815826491,103.36989599510413,89.56045053565528,-10.439549464344717,1.040691594940725,0.6802059364824472,0.031604737547697104,179087700.0,1.0
347,ABBV,2021-07-19,100.82779693603516,102.20804391495955,99.360193987586,101.91976321717789,6762000.0,-1.8170318603515625,1.8170318603515625,0.0,49.74902785491206,96.42450815826491,103.36989599510413,63.39874577506877,-36.60125422493123,0.9446930341818813,0.7331033560223341,0.008439923556448736,172325700.0,-1.0
348,ABBV,2021-07-20,101.3781509399414,102.84575387004472,100.86273939597167,100.94136443294438,5581400.0,0.55035400390625,0.0,0.55035400390625,55.2601087404062,96.44179400951808,103.36989599510413,71.2512162882914,-28.748783711708608,0.90261763749794,0.7670062123174554,0.005085775229565881,177907100.0,1.0
349,ABBV,2021-07-21,102.19930267333984,102.26919011240024,101.15101774676607,101.89355345849192,4133800.0,0.8211517333984375,0.0,0.8211517333984375,62.365770582514614,97.5303791128523,103.36989599510413,79.95393548185302,-20.04606451814698,0.9248713238142727,0.7985792346168189,0.016710201395717217,182040900.0,1.0
350,ABBV,2021-07-22,102.67977142333984,103.00299583332054,101.67516113838163,101.89355438881458,6257000.0,0.48046875,0.0,0.48046875,66.0103388180041,98.39430839341972,103.36989599510413,86.12978753442799,-13.870212465572013,0.9700946954430663,0.8328823267820684,0.01947467346334486,188297900.0,1.0
351,ABBV,2021-07-23,103.24761199951172,103.66692337623283,102.70599425100995,103.06416243909197,4411100.0,0.567840576171875,0.0,0.567840576171875,69.97539659874185,99.1545505883999,103.66692337623283,90.70751916039087,-9.292480839609135,1.0397687254970123,0.8742596065250573,0.015962314217999873,192709000.0,1.0
352,ABBV,2021-07-26,102.89816284179688,103.49219273899187,102.44390115667737,103.1951744579779,3730100.0,-0.34944915771484375,0.34944915771484375,0.0,64.62246507712125,99.360193987586,103.66692337623283,82.14978316347154,-17.850216836528457,1.0546311384509863,0.9103339129102431,0.010119190767315933,188978900.0,-1.0
353,ABBV,2021-07-27,103.04666137695312,103.34367963700385,101.99837653345853,102.898155579344,3773100.0,0.14849853515625,0.0,0.14849853515625,65.90145818637133,99.360193987586,103.66692337623283,85.59784134766379,-14.402158652336203,1.0661029276045895,0.9414877158491125,0.0051122822323894646,192752000.0,1.0
354,ABBV,2021-07-28,103.56207275390625,103.89402806551914,102.47010659945693,102.75838059895885,5650400.0,0.515411376953125,0.0,0.515411376953125,70.21399341106616,99.360193987586,103.89402806551914,92.67826510836458,-7.321734891635416,1.1040569129649356,0.9740015552722772,0.011691467256893295,198402400.0,1.0
355,ABBV,2021-07-29,103.84162902832031,104.0687532186496,103.21265537699816,103.98139724815115,4632200.0,0.2795562744140625,0.0,0.2795562744140625,72.39868329899844,99.360193987586,104.0687532186496,95.17635482143044,-4.823645178569567,1.1435118816424819,1.0079036205463183,0.01165962519463748,203034600.0,1.0
356,ABBV,2021-07-30,101.59654998779297,104.0862318867033,101.43930656971266,103.95519459416411,9017200.0,-2.2450790405273438,2.2450790405273438,0.0,43.10333406269033,99.360193987586,104.0862318867033,47.319891375070426,-52.68010862492957,0.982297795389087,1.002782455514872,0.007624415836889664,194017400.0,-1.0
357,ABBV,2021-08-02,100.85401153564453,102.41770818142568,100.81907447676531,102.11195892997883,9245500.0,-0.7425384521484375,0.7425384521484375,0.0,37.337657235033596,99.360193987586,104.0862318867033,31.608243098040656,-68.39175690195934,0.7855623493452839,0.9593384342809544,-0.0051701416867169225,184771900.0,-1.0
358,ABBV,2021-08-03,101.5528564453125,101.60526869008618,100.36479668833556,101.0461825297244,5902700.0,0.6988449096679688,0.0,0.6988449096679688,45.28553778111617,99.360193987586,104.0862318867033,46.395363400196814,-53.60463659980319,0.678220926015527,0.903114932627869,-0.006325348716845758,190674600.0,1.0
359,ABBV,2021-08-04,100.5307846069336,101.78872522196743,100.38227879329185,101.14228305418385,4602000.0,-1.0220718383789062,1.0220718383789062,0.0,37.30154635135596,99.360193987586,104.0862318867033,24.76896386222861,-75.23103613777138,0.504859710647068,0.8234638882317088,-0.020929018312147996,186072600.0,-1.0
360,ABBV,2021-08-05,100.56571197509766,100.95007950879824,99.98041308237772,100.5744429051864,5132400.0,0.0349273681640625,0.0,0.0349273681640625,37.73439997424135,99.360193987586,104.0862318867033,25.508005082583317,-74.49199491741668,0.3660682383954281,0.7319847582644528,-0.025975419406569333,191205000.0,1.0
361,ABBV,2021-08-06,99.98043823242188,100.94137397047669,99.96296970301806,100.68803697270168,5340400.0,-0.5852737426757812,0.5852737426757812,0.0,33.290668310348565,99.96296970301806,104.0862318867033,0.42365798306333596,-99.57634201693666,0.2064682594276519,0.6268814584970926,-0.028355458725350835,185864600.0,-1.0
362,ABBV,2021-08-09,99.63973999023438,100.62688180262388,99.36019688071555,100.09400170872338,5277900.0,-0.3406982421875,0.3406982421875,0.0,30.85043980396776,99.36019688071555,104.0862318867033,5.914960620576299,-94.0850393794237,0.05189441887183932,0.511884050572042,-0.033061928850425804,180586700.0,-1.0
363,ABBV,2021-08-10,100.30366516113281,100.48711471616743,98.64387490365218,99.76204742853017,5120800.0,0.6639251708984375,0.0,0.6639251708984375,40.634889618795796,98.64387490365218,104.0862318867033,30.497636642536364,-69.50236335746364,-0.01683913965577233,0.4061394125264791,-0.03146332924908102,185707500.0,1.0
364,ABBV,2021-08-11,99.34272766113281,100.75791172736217,99.19422184316637,100.60067497763305,6840400.0,-0.9609375,0.9609375,0.0,32.868042709830036,98.64387490365218,104.0862318867033,12.840994437833475,-87.15900556216653,-0.14715430215279923,0.29548066959062347,-0.04332464166139505,178867100.0,-1.0
365,ABBV,2021-08-12,101.01998901367188,101.09861405547682,99.50871133888715,99.55238599337115,4863600.0,1.6772613525390625,0.0,1.6772613525390625,51.52736277925805,98.64387490365218,104.0862318867033,43.659651827682715,-56.34034817231728,-0.11377747767132007,0.21362904013823475,-0.005675005442511316,183730700.0,1.0
366,ABBV,2021-08-13,101.75379180908203,101.99839119673885,101.07239923153786,101.17723039689083,4416400.0,0.7338027954101562,0.0,0.7338027954101562,57.491755159025566,98.64387490365218,104.0862318867033,57.14283195892739,-42.85716804107261,-0.02779395939620599,0.1653444402313466,0.008921611146022634,188147100.0,1.0
367,ABBV,2021-08-16,103.43978118896484,103.62323071751752,101.95470310356274,102.20804007104016,8180500.0,1.6859893798828125,0.0,1.6859893798828125,67.94749764037917,98.64387490365218,104.0862318867033,88.12186154359831,-11.878138456401691,0.17438366453524168,0.16715228509212562,0.018580715596793418,196327600.0,1.0
368,ABBV,2021-08-17,104.53174591064453,104.6016266837212,103.081611565769,103.15149900367857,6551700.0,1.0919647216796875,0.0,1.0919647216796875,72.92442278438496,98.64387490365218,104.6016266837212,98.82706135374019,-1.172938646259818,0.4179059555039828,0.21730301917449707,0.03979836941842585,202879300.0,1.0
369,ABBV,2021-08-18,102.46138000488281,104.75887464117608,102.36528643978754,104.1036948781628,5586900.0,-2.0703659057617188,2.0703659057617188,0.0,54.43371455859919,98.64387490365218,104.75887464117608,62.42854072102427,-37.57145927897573,0.4387799179913827,0.26159839893787423,0.0188500433453358,197292400.0,-1.0
370,ABBV,2021-08-19,103.02046203613281,103.92024114123944,101.5179154406863,101.5179154406863,6145200.0,0.55908203125,0.0,0.55908203125,57.77010509024055,98.64387490365218,104.75887464117608,71.57133802679137,-28.428661973208634,0.4947329575556694,0.30822531066143327,0.03040618602454881,203437600.0,1.0
371,ABBV,2021-08-20,103.79795837402344,104.36578223784701,102.77587941804143,103.16898465808558,4112500.0,0.777496337890625,0.0,0.777496337890625,62.210074828786624,98.64387490365218,104.75887464117608,84.28591482586495,-15.714085174135045,0.5949553265325562,0.3655713138356579,0.04173252945257189,207550100.0,1.0
372,ABBV,2021-08-23,104.26966857910156,105.221859902184,104.14736889842736,104.65404281255348,4748300.0,0.471710205078125,0.0,0.471710205078125,64.80077935458038,98.64387490365218,105.221859902184,85.52457442066292,-14.475425579337086,0.7043263120160219,0.4333223134717308,0.03953996508101243,212298400.0,1.0
373,ABBV,2021-08-24,104.5492172241211,104.58416094400718,103.44851337462487,104.58416094400718,3831500.0,0.27954864501953125,0.0,0.27954864501953125,66.37696993276606,98.64387490365218,105.221859902184,89.77433548095608,-10.22566451904392,0.8042894966896199,0.5075157501153086,0.0524093679081179,216129900.0,1.0
374,ABBV,2021-08-25,105.17819213867188,106.05176515200829,103.84162649464045,104.70646191169023,5241100.0,0.6289749145507812,0.0,0.6289749145507812,69.87863185405597,98.64387490365218,106.05176515200829,88.20753299456257,-11.792467005437434,0.9236171759087028,0.5907360352739874,0.04116218152070128,221371000.0,1.0
375,ABBV,2021-08-26,105.17819213867188,105.9207278670412,104.95979888533776,105.58003492502664,5035400.0,0.0,0.0,0.0,69.87863185405597,98.64387490365218,106.05176515200829,88.20753299456257,-11.792467005437434,1.00658197101302,0.673905222421794,0.033653785954384396,221371000.0,1.0
376,ABBV,2021-08-27,104.46186828613281,105.38785359850873,104.32209339718287,105.12577901414437,4279900.0,-0.7163238525390625,0.7163238525390625,0.0,60.34893896696248,98.64387490365218,106.05176515200829,78.5377912931649,-21.462208706835106,1.0029692157382186,0.739718021085079,0.009880986651555457,217091100.0,-1.0
377,ABBV,2021-08-30,105.32669830322266,105.61497899814664,104.42691916285375,104.6889870688302,3260900.0,0.8648300170898438,0.0,0.8648300170898438,66.67917013050446,99.19422184316637,106.05176515200829,89.42672592602149,-10.573274073978514,1.0576981499689566,0.8033140468618547,0.0076048896500557905,220352000.0,1.0
378,ABBV,2021-08-31,105.51014709472656,105.85084003548286,104.85496733714398,105.55382841116533,6021800.0,0.18344879150390625,0.0,0.18344879150390625,67.93221251155082,99.50871133888715,106.05176515200829,91.72224357691223,-8.277756423087771,1.1031574960535124,0.8632827367001864,0.02975528037684505,226373800.0,1.0
379,ABBV,2021-09-01,98.07604217529297,106.16533038417732,92.68609812316288,105.7023377397896,50943200.0,-7.434104919433594,7.434104919433594,0.0,24.627613626439043,92.68609812316288,106.16533038417732,39.98702557948537,-60.01297442051463,0.5331681867798181,0.7972598267161127,-0.047994541697023885,175430600.0,-1.0
380,ABBV,2021-09-02,97.85765838623047,99.36020522539683,96.8093733037039,99.19423086397777,14719200.0,-0.2183837890625,0.2183837890625,0.0,24.106735311126613,92.68609812316288,106.16533038417732,38.36687552320861,-61.63312447679139,0.0630984463492581,0.6504275506427418,-0.05722944921891249,160711400.0,-1.0
381,ABBV,2021-09-03,97.50821685791016,97.90132202665143,96.98406774647803,97.12384262014868,5364800.0,-0.3494415283203125,0.3494415283203125,0.0,23.200756344235458,92.68609812316288,106.16533038417732,35.774431669184445,-64.22556833081556,-0.33378455990934697,0.4535851285323241,-0.0648458157902555,155346600.0,-1.0
382,ABBV,2021-09-07,95.24565887451172,97.46453499530283,94.62542287196176,96.48613087961165,12694200.0,-2.2625579833984375,2.2625579833984375,0.0,18.11467436741144,92.68609812316288,106.16533038417732,18.988920895381973,-81.01107910461802,-0.8214179274780946,0.19858451733024027,-0.08898735539707991,142652400.0,-1.0
383,ABBV,2021-09-08,96.40752410888672,96.87925436436517,94.10129174754778,94.39830339090445,10823200.0,1.161865234375,0.0,1.161865234375,27.528236392324246,92.68609812316288,106.16533038417732,27.60859011597569,-72.39140988402431,-1.101421567959548,-0.06141669972771746,-0.08338865549449159,153475600.0,1.0
384,ABBV,2021-09-09,93.70817565917969,95.86590210190721,93.64702581389253,95.60383419274795,10337100.0,-2.6993484497070312,2.6993484497070312,0.0,21.04321857136607,92.68609812316288,106.16533038417732,7.582609426301907,-92.41739057369809,-1.5235784666841852,-0.3538490531190111,-0.10905318152235943,143138500.0,-1.0
385,ABBV,2021-09-10,93.19277954101562,94.6254389066858,92.91323641271008,93.89164069419644,7620100.0,-0.5153961181640625,0.5153961181640625,0.0,20.004971256146604,92.68609812316288,106.16533038417732,3.758978315984695,-96.24102168401531,-1.8780796763455498,-0.6586951777643191,-0.10787753397488431,135518400.0,-1.0
386,ABBV,2021-09-13,93.89163208007812,95.01853542232239,93.30633308543322,93.81300704176266,7398900.0,0.6988525390625,0.0,0.6988525390625,25.737552518161166,92.68609812316288,106.16533038417732,8.943639619609302,-91.0563603803907,-2.0786712514388057,-0.9426903924992166,-0.10856759404177252,142917300.0,1.0
387,ABBV,2021-09-14,93.01806640625,94.4070444329301,92.81714166118597,94.33715698553098,6102700.0,-0.873565673828125,0.873565673828125,0.0,23.32656012286563,92.68609812316288,106.16533038417732,2.4628129900785436,-97.53718700992145,-2.2818274822424343,-1.2105178104478602,-0.11839696022090862,136814600.0,-1.0
388,ABBV,2021-09-15,94.14496612548828,95.04475197939762,92.62495086107708,93.11414964391435,7444300.0,1.1268997192382812,0.0,1.1268997192382812,32.7091403818187,92.62495086107708,106.16533038417732,11.225795125003799,-88.7742048749962,-2.325096603049758,-1.4334335689682398,-0.04008191972896513,144258900.0,1.0
389,ABBV,2021-09-16,94.415771484375,95.00106379509288,93.06173066779907,94.55553969872814,5821800.0,0.27080535888671875,0.0,0.27080535888671875,34.9174589859354,92.62495086107708,106.16533038417732,13.22577864411209,-86.77422135588792,-2.3108973772975645,-1.608926330634105,-0.03517238158582159,150080700.0,1.0
390,ABBV,2021-09-17,94.1100082397461,94.56426319972675,93.55965306602421,93.90908354707275,14157200.0,-0.30576324462890625,0.30576324462890625,0.0,33.48579152369403,92.62495086107708,106.16533038417732,10.96762004444163,-89.03237995555837,-2.2978289848718276,-1.7467068614816497,-0.03485048468393148,135923500.0,-1.0
391,ABBV,2021-09-20,92.94815826416016,93.90034952984327,92.21435355951687,92.68608372718062,7103400.0,-1.1618499755859375,1.1618499755859375,0.0,28.383371698227876,92.21435355951687,106.16533038417732,5.2598804647584245,-94.74011953524158,-2.3540873195152443,-1.868182953088369,-0.024121840695947805,128820100.0,-1.0
392,ABBV,2021-09-21,93.60334777832031,93.83047862324904,92.77344943389473,92.81713074959245,6400400.0,0.6551895141601562,0.0,0.6551895141601562,34.843459617010396,92.21435355951687,106.16533038417732,9.956250635784798,-90.0437493642152,-2.319071326217241,-1.9583606277141434,-0.02908669584128365,135220500.0,1.0
393,ABBV,2021-09-22,92.95690155029297,93.97898031038795,92.53758359842098,93.48104399150839,6319100.0,-0.6464462280273438,0.6464462280273438,0.0,31.598533184384294,92.21435355951687,99.36020522539683,10.391315486180941,-89.60868451381906,-2.3167773402427088,-2.0300439702198565,-0.008017167163931749,128901400.0,-1.0
394,ABBV,2021-09-23,93.78679656982422,94.58174452357214,93.16656054782686,93.4635721647694,5847800.0,0.82989501953125,0.0,0.82989501953125,39.89063095301556,92.21435355951687,97.90132202665143,27.64993369304973,-72.35006630695027,-2.2223755851121183,-2.068510293198309,0.006374067086894364,134749200.0,1.0
395,ABBV,2021-09-24,93.53346252441406,94.38956701232675,92.98311392386296,93.35875058720733,5836100.0,-0.25333404541015625,0.25333404541015625,0.0,38.25709284339583,92.21435355951687,97.46453499530283,25.125016745249372,-74.87498325475063,-2.143296862234962,-2.0834676070056397,-0.0038147122137421885,128913100.0,-1.0
396,ABBV,2021-09-27,94.10128021240234,94.90496573514426,93.48977514218613,93.58586870086535,4969600.0,0.5678176879882812,0.0,0.5678176879882812,44.16985471412889,92.21435355951687,96.87925436436517,40.449448591154756,-59.550551408845244,-2.0116195645032633,-2.0690979985051645,0.011645198056703165,133882700.0,1.0
397,ABBV,2021-09-28,93.76933288574219,94.88751204660824,93.50726495595363,94.01393895097881,6445600.0,-0.33194732666015625,0.33194732666015625,0.0,41.48974689999955,92.21435355951687,95.86590210190721,42.58410666526194,-57.415893334738065,-1.9120092796378998,-2.0376802547317117,-0.003989945030575481,127437100.0,-1.0
398,ABBV,2021-09-29,95.0796890258789,95.72613789150594,93.89163579124501,94.21485355922498,6270100.0,1.3103561401367188,0.0,1.3103561401367188,54.1589415883312,92.21435355951687,95.72613789150594,81.59201122521989,-18.40798877478012,-1.7076479195799124,-1.9716737877013517,0.007031849987200189,133707200.0,1.0
399,ABBV,2021-09-30,94.2323226928711,96.45992986249355,94.15369765650414,95.39416972725859,7886400.0,-0.8473663330078125,0.8473663330078125,0.0,46.62584535062509,92.21435355951687,96.45992986249355,47.53110035825704,-52.46889964174296,-1.5956715424572678,-1.8964733386525352,0.0012996965510130298,125820800.0,-1.0
400,ABBV,2021-10-01,95.29808044433594,95.82222960410691,93.35875387955032,94.56428228439005,8611500.0,1.0657577514648438,0.0,1.0657577514648438,55.59017143228492,92.21435355951687,96.45992986249355,72.63388206347837,-27.36611793652164,-1.4047387592106304,-1.7981264227641545,0.02528207362105306,134432300.0,1.0
401,ABBV,2021-10-04,94.98359680175781,96.26774353464872,94.07508006687252,95.07968370170896,9779200.0,-0.314483642578125,0.314483642578125,0.0,52.583253612621526,92.21435355951687,96.45992986249355,65.22655688226251,-34.773443117737486,-1.2642261425796164,-1.691346366727247,0.014745722842160802,124653100.0,-1.0
402,ABBV,2021-10-05,95.66497039794922,96.59969313682595,95.30680230888325,95.56013925033257,7146900.0,0.6813735961914062,0.0,0.6813735961914062,58.23143054254909,92.21435355951687,96.59969313682595,78.68528257849782,-21.314717421502188,-1.0853761857784718,-1.570152330537492,0.029132520582036525,131800000.0,1.0
403,ABBV,2021-10-06,95.49900817871094,95.8047574216302,94.47692928173784,95.48153964975853,5710300.0,-0.16596221923828125,0.16596221923828125,0.0,56.345155729922425,92.21435355951687,96.59969313682595,74.900804402691,-25.09919559730901,-0.9461217677592089,-1.4453462179818355,0.018256424907443947,126089700.0,-1.0
404,ABBV,2021-10-07,96.8530502319336,97.65673586973244,95.70866495969426,95.90085210456654,7842600.0,1.3540420532226562,0.0,1.3540420532226562,66.54654481424893,92.21435355951687,97.65673586973244,85.23283385861559,-14.767166141384418,-0.7182225383672716,-1.2999214820589229,0.03549091007566463,133932300.0,1.0
405,ABBV,2021-10-08,97.12384796142578,97.6217843128038,96.65211773409399,97.01028586894769,5019800.0,0.2707977294921875,0.0,0.2707977294921875,68.2582108903008,92.53758359842098,97.65673586973244,89.59030948750927,-10.409690512490716,-0.5098820407546469,-1.1419135937980678,0.03212036799287965,138952100.0,1.0
406,ABBV,2021-10-11,96.39002990722656,97.31602170678327,96.33761766634245,97.08889088823176,4613800.0,-0.7338180541992188,0.7338180541992188,0.0,58.844231568340035,92.53758359842098,97.65673586973244,75.25555218185829,-24.74444781814171,-0.3993798769685668,-0.9934068504321676,0.02794833812753783,134338300.0,-1.0
407,ABBV,2021-10-12,94.84381866455078,96.32015914116427,94.48565720660389,96.19785945651577,6305800.0,-1.5462112426757812,1.5462112426757812,0.0,44.06783865257737,92.98311392386296,97.65673586973244,39.81290661159062,-60.18709338840937,-0.43159725658644277,-0.8810449316630226,-0.0024807649640494756,128032500.0,-1.0
408,ABBV,2021-10-13,94.80888366699219,95.2544077962435,94.34589100896969,94.86129591813932,5471100.0,-0.03493499755859375,0.03493499755859375,0.0,43.781228037412745,92.98311392386296,97.65673586973244,39.065413597324266,-60.93458640267574,-0.45470714348164165,-0.7957773740267464,0.00611850538801062,122561400.0,-1.0
409,ABBV,2021-10-14,96.29428100585938,96.36500898193584,95.3128586654334,95.4543213632207,7289500.0,1.4853973388671875,0.0,1.4853973388671875,57.38033485029191,93.35875387955032,97.65673586973244,68.30012626890193,-31.699873731098066,-0.3491380974245857,-0.7064495187063143,0.010453521801053745,129850900.0,1.0
410,ABBV,2021-10-15,96.66561889648438,97.22263959880577,96.44457797158377,96.50646916073059,4634500.0,0.371337890625,0.0,0.371337890625,60.16018194299972,93.35875387955032,97.65673586973244,76.93994587431784,-23.060054125682157,-0.23282612878387,-0.6117248407218255,0.01770855338566668,134485400.0,1.0
411,ABBV,2021-10-18,94.98571014404297,96.36500340947231,94.68509096697296,96.36500340947231,7949400.0,-1.6799087524414062,1.6799087524414062,0.0,44.88001231250249,93.35875387955032,97.65673586973244,37.85395723409505,-62.14604276590495,-0.2730550438181325,-0.543990881341087,-0.007100407297265132,126536000.0,-1.0
412,ABBV,2021-10-19,95.0033950805664,95.55157905038952,94.48174169036939,95.26864691175308,4614900.0,0.0176849365234375,0.0,0.0176849365234375,45.049546011793794,93.35875387955032,97.65673586973244,38.265427932758634,-61.734572067241366,-0.3000509219847771,-0.495202889469825,-0.005189719847321084,131150900.0,1.0
413,ABBV,2021-10-20,95.85218811035156,96.47109999018791,95.04759592093073,95.04759592093073,5626800.0,0.8487930297851562,0.0,0.8487930297851562,53.04707440454883,93.35875387955032,97.65673586973244,58.01406884665854,-41.98593115334146,-0.25007216977368785,-0.4461767455305976,-0.01033382138389316,136777700.0,1.0
414,ABBV,2021-10-21,96.16165161132812,96.32963813727308,94.73814743014277,95.85219564707785,4811800.0,0.3094635009765625,0.0,0.3094635009765625,55.75598442075052,94.07508006687252,97.65673586973244,58.25717654916745,-41.74282345083255,-0.18337865534493858,-0.39361712749346583,-0.009906901037115112,141589500.0,1.0
415,ABBV,2021-10-22,96.49764251708984,96.56837724438506,95.76378489908035,96.08208442627398,4614400.0,0.33599090576171875,0.0,0.33599090576171875,58.738245154089704,94.34589100896969,97.65673586973244,64.99100980601168,-35.008990193988325,-0.10223342329192064,-0.33534038665315685,0.0011164288460834282,146203900.0,1.0
416,ABBV,2021-10-25,95.9317855834961,96.49764995419953,95.2686626416747,96.44460227745715,5697400.0,-0.56585693359375,0.56585693359375,0.0,51.93552471952959,94.34589100896969,97.65673586973244,47.899996563446535,-52.100003436553465,-0.08263263022318768,-0.28479883536716305,0.01147114207614619,140506500.0,-1.0
417,ABBV,2021-10-26,96.80708312988281,96.88666137185002,95.66651112966721,96.20585153470638,5047400.0,0.8752975463867188,0.0,0.8752975463867188,60.16894746409293,94.34589100896969,97.65673586973244,74.33728321375085,-25.662716786249153,0.003490104573472763,-0.22714104737903587,0.021076078375831475,145553900.0,1.0
418,ABBV,2021-10-27,95.84335327148438,97.01044916897924,95.63999263788743,96.88666678179298,4875300.0,-0.9637298583984375,0.9637298583984375,0.0,49.415109636882136,94.34589100896969,97.6217843128038,45.71157005516804,-54.28842994483196,-0.005953326721041208,-0.18290350324743693,-0.0046828090896442465,140678600.0,-1.0
419,ABBV,2021-10-28,96.96625518798828,97.1696158570398,95.66653315030052,95.83452645318503,5193300.0,1.1229019165039062,0.0,1.1229019165039062,59.215086114992495,94.34589100896969,97.31602170678327,88.22386775597221,-11.776132244027789,0.07629203898551395,-0.13106439480084675,0.003110064311757421,145871900.0,1.0
420,ABBV,2021-10-29,101.38705444335938,101.60809537835176,98.51352228845825,99.1059103752857,16545000.0,4.420799255371094,0.0,4.420799255371094,78.30656153353095,94.34589100896969,101.60809537835176,96.95628319241041,-3.0437168075895906,0.4925162172298201,-0.006348272394713341,0.06739270875175807,162416900.0,1.0
421,ABBV,2021-11-01,101.5108413696289,102.31543364690879,100.41448017178507,101.89987559122659,7096800.0,0.12378692626953125,0.0,0.12378692626953125,78.62976142414414,94.34589100896969,102.31543364690879,89.9041599520453,-10.095840047954692,0.8228798015141905,0.15949734238706748,0.06849698669762216,169513700.0,1.0
422,ABBV,2021-11-02,103.03160858154297,104.05724184782292,101.82030846868511,101.89987997436135,10357800.0,1.5207672119140625,0.0,1.5207672119140625,82.35603591866379,94.48174169036939,104.05724184782292,89.28898491551269,-10.711015084487306,1.1936488852912248,0.36632765096789904,0.07490095544742248,179871500.0,1.0
423,ABBV,2021-11-03,103.95114135742188,103.98650872014368,102.77520184305202,103.03161016355907,6186900.0,0.9195327758789062,0.0,0.9195327758789062,84.26965738961322,94.48174169036939,104.05724184782292,98.89195876292207,-1.1080412370779316,1.543887689342867,0.6018396586428928,0.08100411770773008,186058400.0,1.0
424,ABBV,2021-11-04,103.50019836425781,104.08374963176287,102.8547626545267,103.95112373045413,4912200.0,-0.4509429931640625,0.4509429931640625,0.0,79.3969955260462,94.48174169036939,104.08374963176287,93.92261211335375,-6.077387886646247,1.7647244886256033,0.8344166246394351,0.07256711837211793,181146200.0,-1.0
425,ABBV,2021-11-05,103.6063232421875,103.730105645156,102.12092766093039,103.20845219630802,4635800.0,0.1061248779296875,0.0,0.1061248779296875,79.715490818397,94.48174169036939,104.08374963176287,95.02784841994117,-4.972151580058832,1.9260997548087317,1.0527532506732946,0.07999994592002801,185782000.0,1.0
426,ABBV,2021-11-08,102.61603546142578,103.84502244798429,102.36847070810947,103.62398152600421,7015000.0,-0.9902877807617188,0.9902877807617188,0.0,68.34068679553047,94.73814743014277,104.08374963176287,84.29513541585736,-15.704864584142639,1.9515861973152653,1.2325198400016888,0.0600054473674132,178767000.0,-1.0
427,ABBV,2021-11-09,102.2181625366211,103.08463915658413,102.04133250068718,102.77518322088305,3146800.0,-0.3978729248046875,0.3978729248046875,0.0,64.10042216612587,94.73814743014277,104.08374963176287,80.03780757094101,-19.962192429058987,1.9175747585845215,1.3695308237182555,0.06651279455007719,175620200.0,-1.0
428,ABBV,2021-11-10,103.22611999511719,103.53557596503352,102.02365673004152,102.03250025650605,4981100.0,1.0079574584960938,0.0,1.0079574584960938,69.61184443138555,95.2686626416747,104.08374963176287,90.27088856173495,-9.72911143826505,1.9494817789622942,1.4855210147670634,0.06455714717447747,180601300.0,1.0
429,ABBV,2021-11-11,103.1200180053711,103.88039938676981,102.81940556165422,103.39411336093943,3120900.0,-0.10610198974609375,0.10610198974609375,0.0,68.33756959674497,95.2686626416747,104.08374963176287,89.06724769165169,-10.932752308348311,1.943799863791753,1.5771767845720015,0.01709255260966125,177480400.0,-1.0
430,ABBV,2021-11-12,103.4206314086914,103.8008220781204,102.94318219041078,103.8008220781204,2740300.0,0.3006134033203125,0.0,0.3006134033203125,70.12535519585585,95.63999263788743,104.08374963176287,92.14664486966586,-7.853355130334137,1.9411772118427706,1.6499768700261555,0.018813655894235337,180220700.0,1.0
431,ABBV,2021-11-15,103.30567932128906,104.15448237535837,102.7575021665097,103.4029378640338,3941000.0,-0.11495208740234375,0.11495208740234375,0.0,68.42078202522754,95.63999263788743,104.15448237535837,90.03107549318126,-9.968924506818745,1.9078307828381895,1.7015476525885624,0.002660064649278704,176279700.0,-1.0
432,ABBV,2021-11-16,102.93433380126953,103.86270836167063,102.86359908805862,103.10232705873709,3476400.0,-0.37134552001953125,0.37134552001953125,0.0,62.73656628123259,95.66653315030052,104.15448237535837,85.62493080794174,-14.375069192058266,1.8303399974588075,1.7273061215626113,-0.009781591071291729,172803300.0,-1.0
433,ABBV,2021-11-17,103.75662994384766,103.99535796894573,102.78405102520925,103.0935070340076,4361500.0,0.822296142578125,0.0,0.822296142578125,69.26133958807505,98.51352228845825,104.15448237535837,92.9470794797035,-7.052920520296495,1.8143655416839408,1.7447180055868774,0.002477595054333648,177164800.0,1.0
434,ABBV,2021-11-18,103.50904846191406,104.65846401872459,103.12885778502755,103.80966764034324,3160300.0,-0.24758148193359375,0.24758148193359375,0.0,65.28974129256315,100.41448017178507,104.65846401872459,72.91658973585848,-27.08341026414151,1.761423322313675,1.7480590689322368,-0.000938888450331854,174004500.0,-1.0
435,ABBV,2021-11-19,102.77519226074219,104.15449229575383,102.43921246466239,104.00417933179202,5885800.0,-0.733856201171875,0.733856201171875,0.0,54.58474685022054,101.82030846868511,104.65846401872459,33.64451930916168,-66.35548069083832,1.6413299398382009,1.72671324311343,0.0015509934543926907,168118700.0,-1.0
436,ABBV,2021-11-22,102.2535400390625,103.74777220417994,101.68767577316582,102.51878511928237,3975800.0,-0.5216522216796875,0.5216522216796875,0.0,48.11430793604612,101.68767577316582,104.65846401872459,19.047613600283615,-80.95238639971637,1.4869217855728465,1.678754951605313,0.0003460980080594034,164142900.0,-1.0
437,ABBV,2021-11-23,105.10938262939453,105.50726035843728,102.69561940486463,103.05812302931622,8948300.0,2.8558425903320312,0.0,2.8558425903320312,70.33062164772434,101.68767577316582,105.50726035843728,89.58321984602757,-10.41678015397243,1.5768182612538624,1.658367613535023,0.018244051354118662,173091200.0,1.0
438,ABBV,2021-11-24,104.91485595703125,105.42766571807223,104.40203945035734,104.93253626094318,5792800.0,-0.19452667236328125,0.19452667236328125,0.0,68.04087682639104,101.68767577316582,105.50726035843728,84.49034474349973,-15.50965525650027,1.6137627368695036,1.6494466382019193,0.01740533008408396,167298400.0,-1.0
439,ABBV,2021-11-26,103.01392364501953,104.42858434043809,102.41269200626236,103.98650245151765,5016700.0,-1.9009323120117188,1.9009323120117188,0.0,49.770422137301345,101.68767577316582,105.50726035843728,34.72230663428163,-65.27769336571836,1.4726760562726326,1.6140925218160624,-0.003932559278860603,162281700.0,-1.0
440,ABBV,2021-11-29,103.34989929199219,104.2605868672086,103.07581069049746,103.29685162606005,4372500.0,0.33597564697265625,0.0,0.33597564697265625,52.378221173119485,101.68767577316582,105.50726035843728,43.518437194348245,-56.481562805651755,1.372156901645866,1.5657053977820234,0.0004280497548019291,166654200.0,1.0
441,ABBV,2021-11-30,101.9264144897461,103.26150388294158,101.76726471608282,103.16424531316763,8172100.0,-1.4234848022460938,1.4234848022460938,0.0,41.775269245234,101.68767577316582,105.50726035843728,6.250384335010217,-93.74961566498979,1.164211119332947,1.4854065420922082,-0.009791867050593428,158482100.0,-1.0
442,ABBV,2021-12-01,102.4834213256836,105.19780371075844,102.21816950805866,102.36847572341695,6287500.0,0.5570068359375,0.0,0.5570068359375,46.65118734699965,101.68767577316582,105.50726035843728,20.83330097168718,-79.16669902831282,1.0324568651815582,1.3948166067100785,-0.012271106134163268,164769600.0,1.0
443,ABBV,2021-12-02,103.33221435546875,103.97765008083798,102.20932267556647,102.78403043140645,4919800.0,0.8487930297851562,0.0,0.8487930297851562,53.498292529698915,101.68767577316582,105.50726035843728,43.05543039011012,-56.94456960988988,0.9851746927645451,1.3128882239209718,-0.00170839273544654,169689400.0,1.0
444,ABBV,2021-12-03,105.0828628540039,105.21548876880573,103.44716122647286,104.10144052835842,6428100.0,1.7506484985351562,0.0,1.7506484985351562,64.3785446331964,101.68767577316582,105.50726035843728,88.88890938376194,-11.111090616238062,1.0765560653379111,1.2656217922043598,0.0224535760284168,176117500.0,1.0
445,ABBV,2021-12-06,107.29325866699219,108.2658373427335,105.40114897644513,105.77249609426089,8939900.0,2.2103958129882812,0.0,2.2103958129882812,73.43407670929741,101.68767577316582,108.2658373427335,85.2150381918145,-14.784961808185496,1.3122105837424414,1.2749395505119763,0.04928649537223295,185057400.0,1.0
446,ABBV,2021-12-07,107.43474578857422,107.99176655705858,106.9838203594386,107.85030385604877,6123300.0,0.14148712158203125,0.0,0.14148712158203125,73.92367895617262,101.68767577316582,108.2658373427335,87.36589934178363,-12.63410065821636,1.493172947362325,1.318586229882046,0.022123269122212408,191180700.0,1.0
447,ABBV,2021-12-08,107.75304412841797,108.25701722175822,106.76277824955889,107.83261563206592,5278100.0,0.31829833984375,0.0,0.31829833984375,75.11419577966734,101.68767577316582,108.2658373427335,92.20461205015314,-7.795387949846861,1.6433276816119928,1.3835345202280356,0.027052300129441376,196458800.0,1.0
448,ABBV,2021-12-09,109.7689437866211,110.04303242266653,107.95640518827159,108.05366375182994,8082300.0,2.015899658203125,0.0,2.015899658203125,81.33986931356402,101.68767577316582,110.04303242266653,96.71960578652484,-3.28039421347517,1.9030554070305215,1.487438697588533,0.06557385548073102,204541100.0,1.0
449,ABBV,2021-12-10,110.93602752685547,111.4134767644951,109.38874095410326,109.38874095410326,7059500.0,1.167083740234375,0.0,1.167083740234375,84.01174761103925,101.68767577316582,111.4134767644951,95.09090060484183,-4.909099395158164,2.177959246314103,1.6255428073336473,0.073402376652834,211600600.0,1.0
450,ABBV,2021-12-13,111.85556030273438,112.9430779610275,110.69730117833623,110.69730117833623,7834200.0,0.9195327758789062,0.0,0.9195327758789062,85.85324807028552,101.76726471608282,112.9430779610275,90.2690065191895,-9.7309934808105,2.441872740736727,1.7888087940142636,0.09741484445121107,219434800.0,1.0
451,ABBV,2021-12-14,112.54520416259766,113.04033370230371,110.85644816796095,111.13938029716928,6381400.0,0.6896438598632812,0.0,0.6896438598632812,87.13548913398387,101.76726471608282,113.04033370230371,95.60785496557101,-4.392145034428998,2.6758292879716095,1.9662128928057327,0.09817961487584004,225816200.0,1.0
452,ABBV,2021-12-15,115.14463806152344,115.6309308082412,112.81928989456827,113.39399766460728,9585600.0,2.5994338989257812,0.0,2.5994338989257812,90.77282563969176,101.76726471608282,115.6309308082412,96.49232213553654,-3.507677864463457,3.035997044403601,2.1801697231253065,0.11431501569703406,235401800.0,1.0
453,ABBV,2021-12-16,116.51510620117188,117.84135192070981,114.86172418802069,115.02971747109856,9569000.0,1.3704681396484375,0.0,1.3704681396484375,92.12698387784579,101.76726471608282,117.84135192070981,91.74916931422288,-8.250830685777116,3.3929065964017155,2.4227170977805885,0.10879265216680745,244970800.0,1.0
454,ABBV,2021-12-17,114.52572631835938,115.8431351265978,114.38425688433354,115.68397864050179,12631100.0,-1.9893798828125,1.9893798828125,0.0,73.94953871316052,101.76726471608282,117.84135192070981,79.37285296426649,-20.62714703573352,3.4751740143365453,2.63320848109178,0.06740840702596906,232339700.0,-1.0
455,ABBV,2021-12-20,115.70166015625,116.17026582917848,113.37630535156434,113.62387010362968,7119200.0,1.175933837890625,0.0,1.175933837890625,77.03942076934146,102.20932267556647,117.84135192070981,86.31213049243377,-13.687869507566235,3.5938321093099574,2.8253332067354155,0.07694823780701854,239458900.0,1.0
456,ABBV,2021-12-21,114.8970947265625,116.13493226645545,114.18976091680516,116.02882342566616,6085900.0,-0.8045654296875,0.8045654296875,0.0,70.44324492389356,102.20932267556647,117.84135192070981,81.16522718851711,-18.834772811482885,3.5816606439230583,2.9765986941729445,0.06630022061957153,233373000.0,-1.0
457,ABBV,2021-12-22,116.75383758544922,117.22244334060592,114.74678189427063,114.86172751049494,7070900.0,1.8567428588867188,0.0,1.8567428588867188,75.93080288727207,103.44716122647286,117.84135192070981,92.4447691547118,-7.555230845288194,3.6794241894835693,3.1171637932350698,0.06363269571406271,240443900.0,1.0
458,ABBV,2021-12-23,117.67333984375,118.27457815604198,116.85991088463365,117.00138031002787,5702300.0,0.9195022583007812,0.0,0.9195022583007812,78.23937130999099,105.40114897644513,118.27457815604198,95.32961805355727,-4.670381946442737,3.7874394074426334,3.2512189160765828,0.06073150866397814,246146200.0,1.0
459,ABBV,2021-12-27,118.84046173095703,118.902346182609,117.73525696110126,117.76178079627626,4436800.0,1.1671218872070312,0.0,1.1671218872070312,80.9196437819349,106.76277824955889,118.902346182609,99.49022525354067,-0.5097747464593193,3.9220087526015135,3.385376883381569,0.0624457238363314,250583000.0,1.0
460,ABBV,2021-12-28,118.82276153564453,119.59197965318482,118.2480605153874,118.96423096844458,4237200.0,-0.0177001953125,0.0177001953125,0.0,80.74560895190956,106.76277824955889,119.59197965318482,94.0041621193749,-5.995837880625102,3.9813333378993434,3.504568174285124,0.055778097518731196,246345800.0,-1.0
461,ABBV,2021-12-29,119.68040466308594,120.13132331467324,118.54867615256765,119.01728185655094,5594300.0,0.8576431274414062,0.0,0.8576431274414062,82.81230372775595,107.95640518827159,120.13132331467324,96.29633113828116,-3.703668861718844,4.050857369733151,3.6138260133747293,0.03939190463336195,251940100.0,1.0
462,ABBV,2021-12-30,120.18437194824219,120.98012741725192,119.9191336165071,120.02522894920114,6354300.0,0.50396728515625,0.0,0.50396728515625,83.97830407314844,109.38874095410326,120.98012741725192,93.13494143656068,-6.865058563439323,4.099366666769441,3.7109341440536725,0.03149175988163333,258294400.0,1.0
463,ABBV,2021-12-31,119.71575164794922,120.43193553014046,119.62734337856993,120.28161583878934,3963400.0,-0.46862030029296875,0.46862030029296875,0.0,78.28057646389638,110.69730117833623,120.98012741725192,87.70400530043354,-12.295994699566464,4.053273281042095,3.779401971451357,0.04531755000760773,254331000.0,-1.0
464,ABBV,2022-01-03,119.73343658447266,119.98100132039036,118.04468082132476,119.72459980507068,6839800.0,0.0176849365234375,0.0,0.0176849365234375,78.34455466380292,110.85644816796095,120.98012741725192,87.68539774838699,-12.314602251613008,3.9723798452115204,3.81799754620339,0.034846314415695634,261170800.0,1.0
465,ABBV,2022-01-04,119.50360107421875,120.440812689709,118.81395428201759,119.65390732469633,6298300.0,-0.22983551025390625,0.22983551025390625,0.0,75.03032879656251,112.81928989456827,120.98012741725192,81.9071714278215,-18.092828572178497,3.845398054552348,3.823477647873182,0.0400924528041291,254872500.0,-1.0
466,ABBV,2022-01-05,120.13135528564453,122.14724807470596,119.36213694255498,119.36213694255498,7724900.0,0.6277542114257812,0.0,0.6277542114257812,77.96766838415957,113.37630535156434,122.14724807470596,77.01623585179036,-22.983764148209644,3.752165955607751,3.809215309420096,0.02892853691188857,262597400.0,1.0
467,ABBV,2022-01-06,119.56546020507812,120.8298213837792,119.50357575800128,120.59993017423274,4667000.0,-0.5658950805664062,0.5658950805664062,0.0,69.46768020955402,113.37630535156434,122.14724807470596,70.56430590048278,-29.435694099517217,3.591218510342628,3.765615949604603,0.016079431108529274,257930400.0,-1.0
468,ABBV,2022-01-07,119.25602722167969,120.10481698261457,118.5929043185187,119.58316353669939,8630300.0,-0.3094329833984375,0.3094329833984375,0.0,64.99698002764896,113.37630535156434,122.14724807470596,67.03637289298501,-32.963627107015,3.3995104048599103,3.692394840655665,0.003496835039765056,249300100.0,-1.0
469,ABBV,2022-01-10,120.59111022949219,121.04202894835359,118.98193899434891,119.43285771321031,9794400.0,1.3350830078125,0.0,1.3350830078125,73.49044289019513,114.18976091680516,122.14724807470596,80.44435618512162,-19.555643814878376,3.3170732356050934,3.6173305196455505,0.014882238646820145,259094500.0,1.0
470,ABBV,2022-01-11,121.10391235351562,121.21000768844453,119.18527859636325,120.11365325079657,7159400.0,0.5128021240234375,0.0,0.5128021240234375,76.06446283888997,114.74678189427063,122.14724807470596,85.90175678461168,-14.098243215388322,3.2555915973861858,3.5449827351936776,0.011894241955790807,266253900.0,1.0
471,ABBV,2022-01-12,121.3868408203125,121.47526259583994,120.27279930151805,120.7060444155725,6589300.0,0.282928466796875,0.0,0.282928466796875,77.45787328036278,116.85991088463365,122.14724807470596,85.618332497855,-14.381667502145016,3.1928912559918103,3.474564439353304,0.010005201612969694,272843200.0,1.0
472,ABBV,2022-01-13,119.27857208251953,120.70790564451262,118.72469288871783,120.60070937596103,8386400.0,-2.1082687377929688,2.1082687377929688,0.0,51.62022409025561,117.73525696110126,122.14724807470596,34.980014276532614,-65.01998572346737,2.939199849821918,3.367491521447027,-0.0036518132276804893,264456800.0,-1.0
473,ABBV,2022-01-14,121.37791442871094,121.53872246921996,118.17976052041352,119.12671091170968,10484500.0,2.0993423461914062,0.0,2.0993423461914062,65.02479466216623,118.04468082132476,122.14724807470596,81.24750678100499,-18.752493218995017,2.8744125267374585,3.268875722505113,0.01373449130960247,274941300.0,1.0
474,ABBV,2022-01-18,122.19084930419922,123.26285286887796,120.85084144053457,121.05630549620898,12341900.0,0.8129348754882812,0.0,0.8129348754882812,68.87764312189556,118.04468082132476,123.26285286887796,79.45633921400884,-20.54366078599116,2.855745895849978,3.1862497571740866,0.022486755259463198,287283200.0,1.0
475,ABBV,2022-01-19,120.78829193115234,122.83403088412157,120.45774745151489,121.86029529261586,6196700.0,-1.402557373046875,1.402557373046875,0.0,56.48959455666076,118.04468082132476,123.26285286887796,52.57801170266251,-47.4219882973375,2.6966920111697306,3.088338207973216,0.0054684860912936895,281086500.0,-1.0
476,ABBV,2022-01-20,118.84083557128906,120.42204874601808,118.5907018480994,120.15404443366756,6612800.0,-1.9474563598632812,1.9474563598632812,0.0,43.853251073012686,118.04468082132476,123.26285286887796,15.257349560515529,-84.74265043948446,2.385992967272543,2.9478691598330817,-0.006060484629475726,274473700.0,-1.0
477,ABBV,2022-01-21,117.9028091430664,119.93069131577404,117.62587639440085,118.86761634024101,7583000.0,-0.9380264282226562,0.9380264282226562,0.0,39.00417191685053,117.62587639440085,123.26285286887796,4.9127887958987255,-95.08721120410128,2.040548668323666,2.766405061531199,-0.01134716718424511,266890700.0,-1.0
478,ABBV,2022-01-24,118.06363677978516,119.03737261636269,114.57960793908339,118.65324354792531,13733800.0,0.16082763671875,0.0,0.16082763671875,40.309901624852245,114.57960793908339,123.26285286887796,40.12358132093131,-59.8764186790687,1.7594768647449968,2.565019422173959,-0.02095903624153639,280624500.0,1.0
479,ABBV,2022-01-25,118.89441680908203,119.9932329704182,116.83973554811335,117.46508339847259,10296500.0,0.830780029296875,0.0,0.830780029296875,47.06414023973693,114.57960793908339,123.26285286887796,49.69120305697428,-50.30879694302571,1.5854859455917136,2.36911272685751,-0.018244625640035705,290921000.0,1.0
480,ABBV,2022-01-26,119.912841796875,121.02951509656238,118.66217315373147,119.07310129450755,8040300.0,1.0184249877929688,0.0,1.0184249877929688,54.367740325281716,114.57960793908339,123.26285286887796,61.419825202578814,-38.58017479742118,1.5123419373543356,2.1977585689568753,-0.012142988593132897,298961300.0,1.0
481,ABBV,2022-01-27,121.46724700927734,123.5487275226547,120.92230993383293,121.0473767889547,8869100.0,1.5544052124023438,0.0,1.5544052124023438,63.288010999306685,114.57960793908339,123.5487275226547,76.79281122318858,-23.207188776811428,1.5617988488431536,2.070566624934131,0.018349271696878056,307830400.0,1.0
482,ABBV,2022-01-28,123.20927429199219,123.26287243404387,120.24339683790686,121.48513711008341,8014400.0,1.7420272827148438,0.0,1.7420272827148438,70.69560855410907,114.57960793908339,123.5487275226547,96.21531157546067,-3.7846884245393313,1.7217140032023366,2.000796100587772,0.015088081484188498,315844800.0,1.0
483,ABBV,2022-01-31,122.28911590576172,122.53924961404996,121.15457210878417,122.22658929432204,10300000.0,-0.9201583862304688,0.9201583862304688,0.0,62.953728082467855,114.57960793908339,123.5487275226547,85.95612863496427,-14.043871365035718,1.753980033463023,1.9514328871628224,0.000804205896939747,305544800.0,-1.0
484,ABBV,2022-02-01,122.38736724853516,123.13776827257051,121.52975634159264,122.71789811194677,7413900.0,0.0982513427734375,0.0,0.0982513427734375,63.44690416025575,114.57960793908339,123.5487275226547,87.05156884911199,-12.948431150888013,1.7671090243048866,1.9145681145912354,0.013238661560793119,312958700.0,1.0
485,ABBV,2022-02-02,123.83457946777344,124.54032452175099,118.85869107246504,120.96697049405577,11363100.0,1.4472122192382812,0.0,1.4472122192382812,70.19128872507153,114.57960793908339,124.54032452175099,92.91471604356657,-7.085283956433429,1.8727044047122092,1.9061953726154304,0.04202043744036765,324321800.0,1.0
486,ABBV,2022-02-03,125.71954345703125,126.59502514199188,124.20979896882557,124.62074074250769,10272700.0,1.8849639892578125,0.0,1.8849639892578125,76.66256598527973,114.57960793908339,126.59502514199188,92.71368051415884,-7.286319485841163,2.0844619650893605,1.9418486911102164,0.06629811766808547,334594500.0,1.0
487,ABBV,2022-02-04,125.64805603027344,127.56874200631563,124.37951698130739,125.20138677509114,6921500.0,-0.0714874267578125,0.0714874267578125,0.0,75.94112905465286,114.57960793908339,127.56874200631563,85.213133022566,-14.786866977433993,2.2209116325940386,1.9976612794069808,0.0642400950652986,327673000.0,-1.0
488,ABBV,2022-02-07,127.32752990722656,127.75632855226274,125.36218801694233,126.11258905357143,9597800.0,1.679473876953125,0.0,1.679473876953125,80.83107691798688,114.57960793908339,127.75632855226274,96.74578631797584,-3.2542136820241674,2.436482232560138,2.0854254700376122,0.07092942902177013,337270800.0,1.0
489,ABBV,2022-02-08,128.20301818847656,128.2834290226206,126.18407785013,126.88088087094276,7559500.0,0.87548828125,0.0,0.87548828125,82.91922609397488,114.57960793908339,128.2834290226206,99.41322326339599,-0.5867767366040151,2.6474499189858847,2.197830359827267,0.06913501729568394,344830300.0,1.0
490,ABBV,2022-02-09,127.92608642578125,128.6228894521696,127.60448398042776,128.6228894521696,5989100.0,-0.2769317626953125,0.2769317626953125,0.0,79.74851444841848,114.57960793908339,128.6228894521696,95.03817518904654,-4.961824810953459,2.7604762002840886,2.310359527918631,0.05317350623753403,338841200.0,-1.0
491,ABBV,2022-02-10,127.48835754394531,129.0159589157201,127.13101392535381,127.8814150774981,7333400.0,-0.4377288818359375,0.4377288818359375,0.0,74.54943780355266,114.57960793908339,129.0159589157201,89.41836912771797,-10.581630872282037,2.7826525930603054,2.404818140946966,0.03473020417125561,331507800.0,-1.0
492,ABBV,2022-02-11,126.86300659179688,128.29235376952278,126.44313636951232,127.62234983582593,6475200.0,-0.6253509521484375,0.6253509521484375,0.0,67.31534293124389,116.83973554811335,129.0159589157201,82.31839003831955,-17.681609961680454,2.718430573063344,2.467540627370242,0.037402271266396836,325032600.0,-1.0
493,ABBV,2022-02-14,127.7474136352539,127.91715014206532,124.56713055372825,126.65753950534709,9931900.0,0.8844070434570312,0.0,0.8844070434570312,71.78341848674643,118.66217315373147,129.0159589157201,87.74800532261989,-12.25199467738011,2.7076858990615733,2.5155696817085085,0.04379574875431347,334964500.0,1.0
494,ABBV,2022-02-15,129.31968688964844,129.94503479561246,127.92608089710032,128.06008986177753,9530100.0,1.5722732543945312,0.0,1.5722732543945312,77.96293024611222,118.85869107246504,129.94503479561246,94.35929534948171,-5.6407046505182965,2.7938343952904034,2.5712226244248875,0.04429382685716177,344494600.0,1.0
495,ABBV,2022-02-16,130.3113250732422,131.51733789352613,128.78372337423522,129.3018615087359,8028900.0,0.99163818359375,0.0,0.99163818359375,80.99230102840428,118.85869107246504,131.51733789352613,90.47281405878695,-9.527185941213046,2.9085961275479093,2.6386973250494923,0.036524008041600275,352523500.0,1.0
496,ABBV,2022-02-17,129.5072784423828,129.9539476751616,128.26553852050833,129.3554125389896,5486600.0,-0.804046630859375,0.804046630859375,0.0,71.76288207917847,118.85869107246504,131.51733789352613,84.12105591097588,-15.878944089024113,2.9012222990480865,2.691202319849211,0.03071454134697915,347036900.0,-1.0
497,ABBV,2022-02-18,128.6675567626953,130.1862296481234,128.07795001842135,129.25716350696928,7585900.0,-0.8397216796875,0.8397216796875,0.0,63.098252685534874,118.85869107246504,131.51733789352613,77.48747420546219,-22.51252579453781,2.7953963757862823,2.7120411310366257,0.010524250776286381,339451000.0,-1.0
498,ABBV,2022-02-22,130.0343780517578,130.7401232531696,126.18409046357117,126.18409046357117,11576800.0,1.3668212890625,0.0,1.3668212890625,69.91944430718354,118.85869107246504,131.51733789352613,88.28500500305441,-11.714994996945595,2.7896621355971405,2.7275653319487287,0.014284842035379386,351027800.0,1.0
499,ABBV,2022-02-23,131.1063690185547,132.52678776303998,129.85570042161865,130.62397216866947,9271000.0,1.071990966796875,0.0,1.071990966796875,74.230185159712,124.20979896882557,132.52678776303998,82.9214781980543,-17.078521801945705,2.8388934247022775,2.749830950499439,0.024860313338972873,360298800.0,1.0
500,ABBV,2022-02-24,129.77529907226562,130.15942811788562,128.16728690524772,128.2923537609455,12070200.0,-1.3310699462890625,1.3310699462890625,0.0,61.58564081454808,124.37951698130739,132.52678776303998,66.22809325371135,-33.77190674628865,2.738930667747894,2.7476508939491304,0.01793843431963582,348228600.0,-1.0
501,ABBV,2022-02-25,133.58984375,134.32238792035204,130.47210086494388,130.54356958629026,8320700.0,3.814544677734375,0.0,3.814544677734375,75.42683316621623,124.56713055372825,134.32238792035204,92.49077556007556,-7.509224439924432,2.9336935456485236,2.7848594242890092,0.0530244185355615,356549300.0,1.0
502,ABBV,2022-02-28,132.00863647460938,132.28556923387873,130.21301733142002,131.00808806630405,11090600.0,-1.581207275390625,1.581207275390625,0.0,64.33896646535271,124.56713055372825,134.32238792035204,76.28200508928822,-23.717994910711777,2.9267169460164126,2.81323092863449,0.03335662709792442,345458700.0,-1.0
503,ABBV,2022-03-01,131.9371795654297,133.55412024491756,130.6150422586891,131.91930897673632,7489900.0,-0.0714569091796875,0.0714569091796875,0.0,63.84954472498683,124.56713055372825,134.32238792035204,75.54950868766413,-24.450491312335863,2.882197783224626,2.8270242995525177,0.020240481080153083,337968800.0,-1.0
504,ABBV,2022-03-02,133.6166534423828,135.1174556631049,131.51730239775605,131.94610108492458,8247200.0,1.679473876953125,0.0,1.679473876953125,70.03179804289314,124.56713055372825,135.1174556631049,85.77482489721349,-14.225175102786503,2.9484476625808753,2.8513089721581895,0.025364858866125717,346216000.0,1.0
505,ABBV,2022-03-03,134.36705017089844,134.70650953950718,132.97344425959926,133.8310416059692,5408400.0,0.750396728515625,0.0,0.750396728515625,72.45988563809905,124.56713055372825,135.1174556631049,92.88737091580687,-7.112629084193133,3.026613003239248,2.8863697783744016,0.037525085747807774,351624400.0,1.0
506,ABBV,2022-03-04,134.50106811523438,134.60826439374154,132.3034626182391,132.7501319537075,5389500.0,0.1340179443359375,0.0,0.1340179443359375,72.91215589900574,124.56713055372825,135.1174556631049,94.15764403958794,-5.8423559604120605,3.0640532286224413,2.9219064684240097,0.04533785749346242,357013900.0,1.0
507,ABBV,2022-03-07,133.5094757080078,134.67081882880495,132.38387377132196,133.1074759899963,7137700.0,-0.9915924072265625,0.9915924072265625,0.0,63.946768830436625,126.18409046357117,135.1174556631049,82.00028859022794,-17.99971140977207,2.979367364416021,2.933398647622412,0.026724453243178514,349876200.0,-1.0
508,ABBV,2022-03-08,131.4547576904297,133.902510141087,130.74902625778887,133.10743940399158,8817500.0,-2.054718017578125,2.054718017578125,0.0,49.41819650179455,126.18409046357117,135.1174556631049,58.99979581192564,-41.00020418807436,2.7151560065624096,2.889750119410412,0.002657297845123807,341058700.0,-1.0
509,ABBV,2022-03-09,132.9645233154297,134.09906723407488,131.99971592373922,132.44638525519224,5368900.0,1.509765625,0.0,1.509765625,57.58779001608192,126.18409046357117,135.1174556631049,75.90009700053932,-24.099902999460674,2.597648001046764,2.831329695737683,0.024574971246170252,346427600.0,1.0
510,ABBV,2022-03-10,133.25930786132812,133.77744584827852,131.9460991220993,132.27664364988232,4635700.0,0.2947845458984375,0.0,0.2947845458984375,59.07687013653875,126.18409046357117,135.1174556631049,79.19991223605464,-20.800087763945353,2.4994960744489276,2.764962971479932,-0.0024742591157635996,351063300.0,1.0
511,ABBV,2022-03-11,133.16104125976562,134.35811163787056,133.08957254045518,133.41117496171995,5171400.0,-0.0982666015625,0.0982666015625,0.0,58.289700885287154,126.18409046357117,135.1174556631049,78.09991688863921,-21.90008311136078,2.386273199930571,2.68922501717006,0.008729768111633396,345891900.0,-1.0
512,ABBV,2022-03-14,135.87681579589844,136.6540160689935,133.12533108415934,134.65293256101975,8647200.0,2.7157745361328125,0.0,2.7157745361328125,70.72755227917418,128.16728690524772,136.6540160689935,90.84216948485673,-9.157830515143276,2.487014805968869,2.648782974929822,0.02985993973378087,354539100.0,1.0
513,ABBV,2022-03-15,139.25363159179688,139.744956938878,135.93041075986102,136.01973644511855,8384300.0,3.3768157958984375,0.0,3.3768157958984375,79.49853875514766,128.16728690524772,139.744956938878,95.75626749031584,-4.243732509684165,2.8069769846634927,2.6804217768765564,0.04218769146051682,362923400.0,1.0
514,ABBV,2022-03-16,139.40548706054688,140.0933615785981,137.145341561072,139.8074866921948,7178900.0,0.15185546875,0.0,0.15185546875,79.81240524699444,130.21301733142002,140.0933615785981,93.03794988471499,-6.9620501152850105,3.0377850881602626,2.751894439133298,0.037497562707822896,370102300.0,1.0
515,ABBV,2022-03-17,141.67457580566406,141.6924463957432,139.54843904930144,140.40603653537164,7227900.0,2.2690887451171875,0.0,2.2690887451171875,84.0282268238831,130.21301733142002,141.6924463957432,99.84432509684069,-0.15567490315931337,3.3650089427820546,2.8745173398630492,0.05333420612157336,377330200.0,1.0
516,ABBV,2022-03-18,142.219482421875,142.43388856302147,140.37920734530715,141.14747897866943,9912800.0,0.5449066162109375,0.0,0.5449066162109375,84.90187992977471,130.6150422586891,142.43388856302147,98.1858961896486,-1.8141038103513993,3.6265015624509545,3.0249141843806306,0.06523886538897372,387243000.0,1.0
517,ABBV,2022-03-21,142.9788055419922,143.7828046039154,142.03186907266797,142.8894662545512,5825000.0,0.7593231201171875,0.0,0.7593231201171875,86.12242009892053,130.74902625778887,143.7828046039154,93.83141986481498,-6.168580135185018,3.8506198288965834,3.1900553132838216,0.08766550601919731,393068000.0,1.0
518,ABBV,2022-03-22,142.943115234375,143.2021910813775,141.16538001062062,142.97885641457287,5756600.0,-0.0356903076171875,0.0356903076171875,0.0,85.74648135664953,130.74902625778887,143.7828046039154,93.55759053712971,-6.4424094628702955,3.9794822657731856,3.347940703781695,0.07504702510212624,387311400.0,-1.0
519,ABBV,2022-03-23,141.52267456054688,143.98828375695203,141.46907643494762,142.94307941397824,6300600.0,-1.420440673828125,1.420440673828125,0.0,71.42818934585873,130.74902625778887,143.98828375695203,81.37652963875804,-18.623470361241957,3.9217811324705565,3.4627087895194677,0.06200967746146291,381010800.0,-1.0
520,ABBV,2022-03-24,143.18429565429688,143.58629525856043,141.90682812477385,142.23735901230506,4638100.0,1.66162109375,0.0,1.66162109375,76.68346719488741,130.74902625778887,143.98828375695203,93.92724174519626,-6.072758254803741,3.9644319998121205,3.5630534315779983,0.07527167330404283,385648900.0,1.0
521,ABBV,2022-03-25,144.122314453125,144.7029790764344,143.1396365646238,143.42551145264775,5129400.0,0.938018798828125,0.0,0.938018798828125,79.17809537472868,130.74902625778887,144.7029790764344,95.83870870959593,-4.1612912904040655,4.027496919717748,3.655942129205948,0.060683631780216185,390778300.0,1.0
522,ABBV,2022-03-28,144.6940460205078,144.7476441525005,142.51429777770875,143.47910504737052,4516500.0,0.5717315673828125,0.0,0.5717315673828125,80.63517712426736,131.9460991220993,144.7476441525005,99.5813151313736,-0.4186848686264113,4.076617572657625,3.740077217896284,0.039068384547835455,395294800.0,1.0
523,ABBV,2022-03-29,144.8816375732422,145.86431541770668,144.0865668195443,145.60525323940112,6154100.0,0.187591552734375,0.0,0.187591552734375,81.13496990772151,131.9460991220993,145.86431541770668,92.93962801271722,-7.060371987282778,4.083609802698646,3.808783734856757,0.039282173378992535,401448900.0,1.0
524,ABBV,2022-03-30,146.28419494628906,146.82020355585024,144.47071868875383,144.47071868875383,5151800.0,1.402557373046875,0.0,1.402557373046875,84.57043408438976,133.08957254045518,146.82020355585024,96.09625654523674,-3.9037434547632617,4.15443610040748,3.8779142079669016,0.032536671554591834,406600700.0,1.0
525,ABBV,2022-03-31,144.81915283203125,147.0971694891423,144.81022435132368,145.5516835568318,8670100.0,-1.4650421142578125,1.4650421142578125,0.0,69.34928929840902,133.12533108415934,147.0971694891423,83.69565556742626,-16.304344432573753,4.045713331943318,3.911474032762185,0.01827928470759499,397930600.0,-1.0
526,ABBV,2022-04-01,145.3283233642578,145.67673851975815,143.02352166933198,144.85485497571526,5703300.0,0.5091705322265625,0.0,0.5091705322265625,71.41259930857738,135.93041075986102,147.0971694891423,84.15971753516766,-15.840282464832345,3.9550442728177586,3.9201880807733005,0.016432630090587708,403633900.0,1.0
527,ABBV,2022-04-04,144.6226043701172,146.36461214225756,144.2384752647616,145.1675415328141,6892400.0,-0.705718994140625,0.705718994140625,0.0,64.47178995059244,137.145341561072,147.0971694891423,75.13456686640147,-24.86543313359853,3.782638859180338,3.892678236454708,0.011749353111469851,396741500.0,-1.0
528,ABBV,2022-04-05,145.99830627441406,148.25846524746024,144.57790131377092,144.6225709655629,6683300.0,1.375701904296875,0.0,1.375701904296875,70.84536762822248,139.54843904930144,148.25846524746024,74.05106573015881,-25.948934269841185,3.7141989991612263,3.8569823889960118,0.031624838406741684,403424800.0,1.0
529,ABBV,2022-04-06,150.89381408691406,151.21541650235318,146.32885366204272,146.94525942757303,8810800.0,4.8955078125,0.0,4.8955078125,83.21165208804119,140.37920734530715,151.21541650235318,97.03215016637068,-2.9678498336293266,4.008775811833885,3.8873410735635874,0.053843324069777765,412235600.0,1.0
530,ABBV,2022-04-07,154.79771423339844,155.9679856389282,149.6699456721771,149.78608405421963,7469000.0,3.903900146484375,0.0,3.903900146484375,87.92451732586987,141.16538001062062,155.9679856389282,92.09415264504635,-7.905847354953643,4.505307790008288,4.010934416852528,0.07407180366747124,419704600.0,1.0
531,ABBV,2022-04-08,156.2985382080078,157.14720721014814,154.1009191030421,154.54758843377553,7204200.0,1.500823974609375,0.0,1.500823974609375,89.2617022381206,141.16538001062062,157.14720721014814,94.68978739699165,-5.310212603008348,4.962709881538132,4.201289509789649,0.0802002052375761,426908800.0,1.0
532,ABBV,2022-04-11,151.71568298339844,156.36996905430814,151.26008524396389,156.2449022063498,8163200.0,-4.582855224609375,4.582855224609375,0.0,64.20972267760658,141.46907643494762,157.14720721014814,65.35604719319458,-34.64395280680541,4.898934352636445,4.340818478359008,0.04716985205734869,418745600.0,-1.0
533,ABBV,2022-04-12,149.46449279785156,152.36784351616652,148.48182842579718,151.25117016296846,8279700.0,-2.251190185546875,2.251190185546875,0.0,55.39740296374139,141.90682812477385,157.14720721014814,49.5897420316176,-50.410257968382396,4.613557335389061,4.3953662497650186,0.021740543144324054,410465900.0,-1.0
534,ABBV,2022-04-13,143.20297241210938,148.65360743411674,140.95064502674396,148.65360743411674,18312600.0,-6.2615203857421875,6.2615203857421875,0.0,38.45817422981492,140.95064502674396,157.14720721014814,13.906206513832098,-86.0937934861679,3.837900697539027,4.28387313931982,-0.011159990845937329,392153300.0,-1.0
535,ABBV,2022-04-14,146.23011779785156,147.6355680485373,141.2840150884858,142.21197297828772,11074800.0,3.0271453857421875,0.0,3.0271453857421875,47.42581430495531,140.95064502674396,157.14720721014814,32.5962553739782,-67.4037446260218,3.4279374285984545,4.112685997175547,0.006205221478633893,403228100.0,1.0
536,ABBV,2022-04-18,143.57237243652344,146.6625593342124,143.02280394706264,145.91479866143231,6500200.0,-2.657745361328125,2.657745361328125,0.0,41.32547926534326,140.95064502674396,157.14720721014814,16.18693757410962,-83.81306242589038,2.855662446290097,3.8612812869984574,-0.00726187955311608,396727900.0,-1.0
537,ABBV,2022-04-19,140.86058044433594,144.59943894308273,138.48212293310075,144.50934033586003,9359900.0,-2.7117919921875,2.7117919921875,0.0,35.89037587661447,138.48212293310075,157.14720721014814,12.74281688703647,-87.25718311296353,2.158430407255281,3.520711111049822,-0.03519031118362026,387368000.0,-1.0
538,ABBV,2022-04-20,141.1759033203125,142.4372151327034,140.11281120059923,140.86959003976304,6250000.0,0.3153228759765625,0.0,0.3153228759765625,37.002014392112926,138.48212293310075,157.14720721014814,14.4321897893829,-85.5678102106171,1.612722453305878,3.1391133795010333,-0.06440231380859718,393618000.0,1.0
539,ABBV,2022-04-21,142.8155975341797,144.49132987976256,139.9596476825632,141.44617845409374,7903300.0,1.6396942138671875,0.0,1.6396942138671875,42.938616527190376,138.48212293310075,157.14720721014814,23.217010632027225,-76.78298936797277,1.2975967007103293,2.770810043742893,-0.07740499760321107,401521300.0,1.0
540,ABBV,2022-04-22,139.6353302001953,142.63543271498028,139.04971667794945,141.6984565782345,7938300.0,-3.180267333984375,3.180267333984375,0.0,35.46032112598043,138.48212293310075,157.14720721014814,6.178419823759741,-93.82158017624026,0.7822193385502771,2.37309190270437,-0.10661141299758348,393583000.0,-1.0
541,ABBV,2022-04-25,140.81552124023438,141.12183448786743,137.69829386086843,139.50015590169775,6932600.0,1.1801910400390625,0.0,1.1801910400390625,39.93932433805492,137.69829386086843,157.14720721014814,16.027771440924177,-83.97222855907583,0.46366576924222613,1.9912066760119411,-0.07184597879941534,400515600.0,1.0
542,ABBV,2022-04-26,140.70741271972656,143.86968968158644,140.38309072068208,140.94166360408218,6787800.0,-0.1081085205078125,0.1081085205078125,0.0,39.64849594185896,137.69829386086843,157.14720721014814,15.471912516745176,-84.52808748325482,0.20017878003741885,1.633001096817037,-0.05858970190310564,393727800.0,-1.0
543,ABBV,2022-04-27,142.00474548339844,143.69850023001447,139.24789871300703,141.04976078485674,6039100.0,1.297332763671875,0.0,1.297332763671875,45.17619785503227,137.69829386086843,157.14720721014814,22.142376518374974,-77.85762348162503,0.09495279779051202,1.3253914370117321,-0.008367332804117278,399766900.0,1.0
544,ABBV,2022-04-28,140.82452392578125,142.74351137550735,139.04968873691413,142.67143524507784,7465000.0,-1.1802215576171875,1.1802215576171875,0.0,41.21379034169172,137.69829386086843,157.14720721014814,16.07406032804706,-83.92593967195295,-0.08272002250106425,1.0437691451091728,-0.03696635107374391,392301900.0,-1.0
545,ABBV,2022-04-29,132.3287811279297,135.0135522967917,126.06729819215198,134.74327018313403,25155900.0,-8.495742797851562,8.495742797851562,0.0,23.843543739249057,126.06729819215198,156.36996905430814,20.663138784896454,-79.33686121510355,-0.8987027684555642,0.6552747623962253,-0.07831305645913733,367146000.0,-1.0
546,ABBV,2022-05-02,133.22067260742188,134.14863050756253,129.22955457535716,132.12153560484646,9690800.0,0.8918914794921875,0.0,0.8918914794921875,27.542711846517747,126.06729819215198,152.36784351616652,27.19857830756947,-72.80142169243052,-1.4566158244039116,0.2328966450361978,-0.05423737295994702,376836800.0,1.0
547,ABBV,2022-05-03,134.77931213378906,135.80637314515988,133.29276741527931,133.38286603353532,6163400.0,1.5586395263671875,0.0,1.5586395263671875,34.00640465037068,126.06729819215198,148.65360743411674,38.57210068411882,-61.42789931588118,-1.7527916658566483,-0.16424101714237152,-0.045309369630951,383000200.0,1.0
548,ABBV,2022-05-04,136.57215881347656,137.27488405744984,132.96843397376986,133.49998008831795,5791500.0,1.7928466796875,0.0,1.7928466796875,40.9927403578409,126.06729819215198,147.6355680485373,48.705161291435736,-51.294838708564264,-1.8218443231353376,-0.4957616783409649,-0.043716784640479456,388791700.0,1.0
549,ABBV,2022-05-05,137.10369873046875,138.1307734605924,135.17570657826226,137.63525856810784,6869300.0,0.5315399169921875,0.0,0.5315399169921875,43.05500254442328,126.06729819215198,146.6625593342124,53.587087156558624,-46.412912843441376,-1.8127816045692953,-0.7591656635866311,-0.018130307466577067,395661000.0,1.0
550,ABBV,2022-05-06,137.68930053710938,138.31094519056654,134.24773716462607,134.85135934703763,6145600.0,0.585601806640625,0.0,0.585601806640625,45.47731465540661,126.06729819215198,144.59943894308273,62.712681179985616,-37.287318820014384,-1.7383080301821678,-0.9549941369057385,-0.02220082470732465,401806600.0,1.0
551,ABBV,2022-05-09,136.0045623779297,138.3289524752818,134.1756596315603,136.59916644507328,6969000.0,-1.6847381591796875,1.6847381591796875,0.0,39.850232069746525,126.06729819215198,144.49132987976256,53.93642582833874,-46.06357417166126,-1.7945450768483795,-1.122904324894267,-0.03342290396003822,394837600.0,-1.0
552,ABBV,2022-05-10,137.02261352539062,139.220887702392,135.59914067721567,136.28385714048255,6525200.0,1.0180511474609375,0.0,1.0180511474609375,44.627379507663306,126.06729819215198,144.49132987976256,59.462095587936126,-40.537904412063874,-1.7369427275518206,-1.2457120054257778,-0.0350842638465928,401362800.0,1.0
553,ABBV,2022-05-11,136.905517578125,139.4281140579384,135.98656386212454,136.0586400111363,5630000.0,-0.117095947265625,0.117095947265625,0.0,44.16189782989803,126.06729819215198,143.86968968158644,60.88069343046071,-39.11930656953929,-1.6813594499355418,-1.3328414943277307,-0.027829004767107812,395732800.0,-1.0
554,ABBV,2022-05-12,139.00465393066406,139.05872134446085,135.27479971151192,138.18481707416828,6914800.0,2.0991363525390625,0.0,2.0991363525390625,54.071010896250634,126.06729819215198,143.86968968158644,72.67201008465787,-27.327989915342133,-1.4511980339374873,-1.3565128022496822,0.05044913695895392,402647600.0,1.0
555,ABBV,2022-05-13,138.29293823242188,139.09476644492705,136.85144282365977,138.22086208727188,6398500.0,-0.7117156982421875,0.7117156982421875,0.0,50.56081009769441,126.06729819215198,143.86968968158644,68.67414441214649,-31.325855587853514,-1.3111093103350981,-1.3474321038667656,0.038074163158949625,396249100.0,-1.0
556,ABBV,2022-05-16,140.06777954101562,141.3471002389947,138.08573358283846,138.68033774730787,6565600.0,1.77484130859375,0.0,1.77484130859375,58.34231345496264,126.06729819215198,143.69850023001447,79.40741260180683,-20.59258739819317,-1.0448289887606848,-1.2869114808455495,0.03923797594379286,402814700.0,1.0
557,ABBV,2022-05-17,139.4460906982422,140.35602600458495,137.70730057137516,139.98665476459578,6032200.0,-0.6216888427734375,0.6216888427734375,0.0,54.85289413120713,126.06729819215198,142.74351137550735,80.22680184637878,-19.773198153621234,-0.8738913340873182,-1.2043074514939034,0.021043321784864677,396782500.0,-1.0
558,ABBV,2022-05-18,137.32891845703125,140.27496694922067,136.71629191887766,139.455116363941,6498100.0,-2.1171722412109375,2.1171722412109375,0.0,44.41466295566346,126.06729819215198,141.3471002389947,73.70265812577244,-26.297341874227552,-0.8988981784815735,-1.1432255968914375,0.001642696212049266,390284400.0,-1.0
559,ABBV,2022-05-19,136.6892852783203,137.3019119069731,134.49101091034157,136.2207971965086,5994800.0,-0.6396331787109375,0.6396331787109375,0.0,41.65165386588271,129.22955457535716,141.3471002389947,61.56139956087308,-38.43860043912692,-0.9592714505567699,-1.106434767624504,-0.007262839268469823,384289600.0,-1.0
560,ABBV,2022-05-20,136.0496063232422,138.31095227981936,133.1666294284631,137.23884202509257,6746400.0,-0.639678955078125,0.639678955078125,0.0,38.861941525998155,132.96843397376986,141.3471002389947,36.77401930019042,-63.22598069980958,-1.0466690994474845,-1.0944816339891001,0.0003311943696957531,377543200.0,-1.0
561,ABBV,2022-05-23,133.36485290527344,136.94155109617336,132.60807394852444,136.62621965730125,6886400.0,-2.68475341796875,2.68475341796875,0.0,29.344104218567708,132.60807394852444,141.3471002389947,8.659762902581663,-91.34023709741832,-1.3173835517274597,-1.139062017536772,-0.02669457636231265,370656800.0,-1.0
562,ABBV,2022-05-24,134.33782958984375,136.35592009342662,132.08550196191874,132.4638913537561,6367200.0,0.9729766845703125,0.0,0.9729766845703125,35.90802558640296,132.08550196191874,141.3471002389947,24.318995064814118,-75.68100493518588,-1.4368524776594427,-1.1986201095613063,-0.01875518265226972,377024000.0,1.0
563,ABBV,2022-05-25,136.905517578125,137.83347565758203,134.95048468558997,135.46402209212897,5042600.0,2.56768798828125,0.0,2.56768798828125,50.04056496766761,132.08550196191874,141.3471002389947,52.043021863047386,-47.956978136952614,-1.3092492897642387,-1.2207459456018928,-0.015101194767091153,382066600.0,1.0
564,ABBV,2022-05-26,135.65321350097656,137.90554143652747,135.49103874111515,136.60819834611115,6659300.0,-1.2523040771484375,1.2523040771484375,0.0,44.516565181803735,132.08550196191874,141.3471002389947,38.521553541018086,-61.478446458981914,-1.2942539630688543,-1.2354475490952852,-0.01908792137317139,375407300.0,-1.0
565,ABBV,2022-05-27,135.13967895507812,135.18472826415362,133.11258377075194,134.7072358316152,8405000.0,-0.5135345458984375,0.5135345458984375,0.0,42.306784156842156,132.08550196191874,141.3471002389947,32.97678113203201,-67.023218867968,-1.3087218735863644,-1.250102413993501,-0.03518368465671595,367002300.0,-1.0
566,ABBV,2022-05-31,132.7702178955078,134.13063271703882,132.13956884601575,133.9144042941623,11227800.0,-2.3694610595703125,2.3694610595703125,0.0,33.463287509452144,132.08550196191874,141.3471002389947,7.393064491728864,-92.60693550827114,-1.4941597583896282,-1.2989138828727267,-0.04787421984586715,355774500.0,-1.0
567,ABBV,2022-06-01,131.55393981933594,133.238676279485,130.02235996946268,133.14857768656267,5597900.0,-1.216278076171875,1.216278076171875,0.0,29.77672093577425,130.02235996946268,141.3471002389947,13.52419405144154,-86.47580594855846,-1.7194434205552795,-1.3830197904092374,-0.0420521671806674,350176600.0,-1.0
568,ABBV,2022-06-02,132.2116241455078,132.49992866389567,128.74303429940275,132.12152554673258,5998900.0,0.657684326171875,0.0,0.657684326171875,34.29316411315328,128.74303429940275,141.3471002389947,27.519610439433766,-72.48038956056624,-1.823888070927154,-1.471193446512821,-0.032757952634658194,356175500.0,1.0
569,ABBV,2022-06-03,132.59002685546875,133.5270028873826,132.21163744735188,132.21163744735188,4891800.0,0.3784027099609375,0.0,0.3784027099609375,36.98378442640028,128.74303429940275,141.3471002389947,30.52183775064052,-69.47816224935947,-1.8547469048008054,-1.547904138170418,-0.02542880910330436,361067300.0,1.0
570,ABBV,2022-06-06,132.013427734375,133.17563650555144,131.22962210761676,132.43686643430848,3912400.0,-0.57659912109375,0.57659912109375,0.0,34.499921559802004,128.74303429940275,140.35602600458495,28.16150668145973,-71.83849331854026,-1.9037838480676612,-1.6190800801498666,-0.010133293303733693,357154900.0,-1.0
571,ABBV,2022-06-07,134.3648681640625,134.55406975007438,131.41881952008194,132.36479995590523,4991200.0,2.3514404296875,0.0,2.3514404296875,50.22892476026289,128.74303429940275,140.27496694922067,48.750144796835194,-51.249855203164806,-1.7329282696484825,-1.64184971804959,0.00020127297203842431,362146100.0,1.0
572,ABBV,2022-06-08,134.4639892578125,135.00455350744565,133.56305800650387,134.1486578210065,4835200.0,0.09912109375,0.0,0.09912109375,50.803534906940975,128.74303429940275,138.31095227981936,59.793102011527125,-40.206897988472875,-1.5714114953782143,-1.6277620735153149,-0.01783367364225652,366981300.0,1.0
573,ABBV,2022-06-09,131.02239990234375,135.60814953113263,130.90528821039777,134.88740192025853,5642900.0,-3.44158935546875,3.44158935546875,0.0,34.73681723976662,128.74303429940275,138.31095227981936,23.823005251574596,-76.17699474842541,-1.7015019314103483,-1.6425100450943217,-0.03413714632421494,361338400.0,-1.0
574,ABBV,2022-06-10,129.01332092285156,130.30165944601248,128.06734059063575,130.0403817485702,5464700.0,-2.0090789794921875,2.0090789794921875,0.0,28.636655011428104,128.06734059063575,137.90554143652747,9.615379346629599,-90.3846206533704,-1.9443027109231252,-1.7028685782600828,-0.045333525131897257,355873700.0,-1.0
575,ABBV,2022-06-13,125.6078109741211,127.99528661195552,125.03121562614885,126.90515394383803,5997000.0,-3.4055099487304688,3.4055099487304688,0.0,21.315495814582277,125.03121562614885,137.90554143652747,4.478644990539407,-95.52135500946059,-2.384038557324203,-1.839102574072907,-0.053945885115769254,349876700.0,-1.0
576,ABBV,2022-06-14,123.98615264892578,126.72499131247729,122.81495303651835,125.62585410168776,5861800.0,-1.6216583251953125,1.6216583251953125,0.0,18.690102603196408,122.81495303651835,137.90554143652747,7.761126215639984,-92.23887378436002,-2.830755470818417,-2.037433153422009,-0.057526115757559615,344014900.0,-1.0
577,ABBV,2022-06-15,124.40957641601562,125.3105075458246,122.73384396468617,123.04017099663096,5981800.0,0.42342376708984375,0.0,0.42342376708984375,21.599361046188307,122.73384396468617,137.90554143652747,11.045121710603674,-88.95487828939632,-3.114710638479721,-2.2528886504335515,-0.0590118136730966,349996700.0,1.0
578,ABBV,2022-06-16,125.36454772949219,125.49067752421384,122.31039207783846,123.01311718373283,6963400.0,0.9549713134765625,0.0,0.9549713134765625,28.277526154522675,122.31039207783846,135.60814953113263,22.96744892799307,-77.03255107200692,-3.2255073102050744,-2.4474123823878564,-0.05449489148872999,356960100.0,1.0
579,ABBV,2022-06-17,124.58073425292969,125.70689797285212,123.5987227884651,123.96810778790743,10429900.0,-0.7838134765625,0.7838134765625,0.0,26.16668045508223,122.31039207783846,135.60814953113263,17.073120660121628,-82.92687933987838,-3.338082332505337,-2.625546372411353,-0.056302556558115224,346530200.0,-1.0
580,ABBV,2022-06-21,129.25660705566406,129.70707267898564,125.86009240662578,126.08532521828657,7160500.0,4.675872802734375,0.0,4.675872802734375,51.22722144798704,122.31039207783846,135.60814953113263,52.23598792670763,-47.76401207329237,-3.0152372137759755,-2.703484540684278,-0.03801783292163197,353690700.0,1.0
581,ABBV,2022-06-22,132.94139099121094,135.2297636848835,129.3827158936335,129.48181886457394,7995700.0,3.684783935546875,0.0,3.684783935546875,62.72983659747766,122.31039207783846,135.60814953113263,79.94580252130355,-20.054197478696445,-2.4339913257389583,-2.6495858976952142,-0.011323464929202998,361686400.0,1.0
582,ABBV,2022-06-23,134.64414978027344,135.86041226082065,132.92336808463386,133.98647392825072,7795000.0,1.7027587890625,0.0,1.7027587890625,66.89303809452349,122.31039207783846,135.86041226082065,91.02390650255452,-8.97609349744548,-1.8150288453774692,-2.4826744872316655,0.027642219045209915,369481400.0,1.0
583,ABBV,2022-06-24,137.24783325195312,137.60821392125848,134.79729968914432,135.94148597512384,8527600.0,2.6036834716796875,0.0,2.6036834716796875,72.34363635712772,122.31039207783846,137.60821392125848,97.64423541472759,-2.355764585272418,-1.1017013961240423,-2.206479869010141,0.06382683795904853,378009000.0,1.0
584,ABBV,2022-06-27,137.9685821533203,140.0497307050184,137.61721958935982,137.8424523546452,5377300.0,0.7207489013671875,0.0,0.7207489013671875,73.7253120606284,122.31039207783846,140.0497307050184,88.26817281389863,-11.731827186101377,-0.4727759734246888,-1.8597390898930506,0.09840766337171414,383386300.0,1.0
585,ABBV,2022-06-28,137.3830108642578,139.75245069686568,136.39198099327515,137.995637513869,5735700.0,-0.5855712890625,0.5855712890625,0.0,70.42698416661574,122.31039207783846,140.0497307050184,84.967196935546,-15.032803064454006,-0.021352614329913422,-1.4920617947804231,0.10805124547469447,377650600.0,-1.0
586,ABBV,2022-06-29,138.86953735351562,141.10384292433278,138.15780774022866,138.65330891229354,6140900.0,1.4865264892578125,0.0,1.4865264892578125,73.85335219919207,122.31039207783846,141.10384292433278,88.11125434563851,-11.888745654361488,0.45115329993677733,-1.1034187758369831,0.11622868073392567,383791500.0,1.0
587,ABBV,2022-06-30,137.9866180419922,138.77942810485246,135.9234780129664,137.9956224045171,7289500.0,-0.8829193115234375,0.8829193115234375,0.0,68.42058092511044,122.31039207783846,141.10384292433278,83.4132384318228,-16.586761568177202,0.7457765834151928,-0.7335797039865478,0.1006829326241061,376502000.0,-1.0
588,ABBV,2022-07-01,138.5631866455078,138.6172403044463,136.45501146421196,137.91451524401438,4620000.0,0.576568603515625,0.0,0.576568603515625,70.07903946917236,122.31039207783846,141.10384292433278,86.48116144513772,-13.518838554862295,1.0141019894589078,-0.38404336529745664,0.11223607306881256,381122000.0,1.0
589,ABBV,2022-07-05,138.68032836914062,138.78844945755768,134.83336217200778,136.8514391942103,5478800.0,0.1171417236328125,0.0,0.1171417236328125,70.44292969890148,122.31039207783846,141.10384292433278,87.10447285606287,-12.895527143937121,1.2221163682791314,-0.06281141858213897,0.07290707630456561,386600800.0,1.0
590,ABBV,2022-07-06,137.41903686523438,139.63533369869063,136.66225794536908,139.29297543855753,5113600.0,-1.26129150390625,1.26129150390625,0.0,61.196515846137224,122.31039207783846,141.10384292433278,80.39313753926272,-19.606862460737272,1.2705474981739542,0.20386036476907973,0.03368135266705208,381487200.0,-1.0
591,ABBV,2022-07-07,136.94154357910156,137.46408532925508,135.1486855267017,135.31986465571467,6516100.0,-0.4774932861328125,0.4774932861328125,0.0,57.87796210561745,122.31039207783846,141.10384292433278,77.85239454302965,-22.147605456970357,1.255922309332533,0.41427275368177047,0.017062707905076024,374971100.0,-1.0
592,ABBV,2022-07-08,137.7073516845703,139.86958125831447,136.7523529799276,136.94155459751238,4078400.0,0.76580810546875,0.0,0.76580810546875,61.71946168922003,123.5987227884651,141.10384292433278,80.59715549850402,-19.40284450149598,1.2912414283764235,0.5896664886207011,0.0033480924378137544,379049500.0,1.0
593,ABBV,2022-07-11,138.0496826171875,139.19386907952645,137.19380073473073,137.19380073473073,4491000.0,0.3423309326171875,0.0,0.3423309326171875,63.43927121994946,125.86009240662578,141.10384292433278,79.96450871065099,-20.035491289349014,1.3315065512734066,0.7380345011512424,0.0005878183467673548,383540500.0,1.0
594,ABBV,2022-07-12,137.35598754882812,139.2569530794633,136.99560679235688,137.84248438616405,5319500.0,-0.693695068359375,0.693695068359375,0.0,57.40880118825886,129.3827158936335,141.10384292433278,68.02478664646756,-31.97521335353244,1.2925419378190384,0.8489359884848017,-0.00019670056187948148,378221000.0,-1.0
595,ABBV,2022-07-13,137.07666015625,138.59023153939165,136.31087697627973,136.9415259912898,5221200.0,-0.279327392578125,0.279327392578125,0.0,54.980543169594974,132.92336808463386,141.10384292433278,50.77079451990586,-49.22920548009414,1.2250017570685827,0.924149142201558,-0.012910514655936067,372999800.0,-1.0
596,ABBV,2022-07-14,136.80386352539062,137.32219053592075,135.03061763298808,135.39435539912478,7576900.0,-0.272796630859375,0.272796630859375,0.0,52.479179864130764,134.79729968914432,141.10384292433278,31.817174027291657,-68.18282597270834,1.1363639724568486,0.9665921082526161,-0.00857151608891249,365422900.0,-1.0
597,ABBV,2022-07-15,139.69561767578125,139.92295725089517,137.7041207776702,138.07696101102658,4873000.0,2.891754150390625,0.0,2.891754150390625,69.46875540991407,134.83336217200778,141.10384292433278,77.54198913648874,-22.458010863511262,1.2846496406986887,1.0302036147418305,0.008172668785184412,370295900.0,1.0
598,ABBV,2022-07-18,136.01272583007812,140.46857589209569,135.39435497871818,139.85930750407002,6838400.0,-3.682891845703125,3.682891845703125,0.0,45.54191349858889,134.83336217200778,141.10384292433278,18.808185602564098,-81.1918143974359,1.092396046750025,1.0426421011434694,-0.019235623180541173,363457500.0,-1.0
599,ABBV,2022-07-19,136.16729736328125,136.61287398610494,135.3124984634173,136.40372549221414,5647100.0,0.154571533203125,0.0,0.154571533203125,46.43534777024864,134.83336217200778,141.10384292433278,21.273252306513587,-78.72674769348642,0.9416515464845077,1.022443990211677,-0.009108923556062298,369104600.0,1.0
600,ABBV,2022-07-20,134.30311584472656,136.8129395014054,133.98483492191684,135.9763316158458,5315700.0,-1.8641815185546875,1.8641815185546875,0.0,37.80455076691264,133.98483492191684,140.46857589209569,4.908908672842009,-95.091091327158,0.664106172471719,0.9507764266636854,-0.01926681754431203,363788900.0,-1.0
601,ABBV,2022-07-21,134.357666015625,134.43950491856197,132.78448030889638,133.89389835661134,4066800.0,0.0545501708984375,0.0,0.0545501708984375,38.19243280908111,132.78448030889638,140.46857589209569,20.47327092297334,-79.52672907702666,0.44343951219181577,0.8493090437693116,-0.02432466842161074,367855700.0,1.0
602,ABBV,2022-07-22,135.01243591308594,135.75810254791335,134.20310753314627,135.01243591308594,3639700.0,0.6547698974609375,0.0,0.6547698974609375,43.10653251556644,132.78448030889638,140.46857589209569,28.99437650230192,-71.00562349769808,0.3177314424002873,0.7429935234955067,-0.022001113269661476,371495400.0,1.0
603,ABBV,2022-07-25,136.6038055419922,137.25854463095294,135.04879673678374,135.07607637584823,4347000.0,1.59136962890625,0.0,1.59136962890625,53.47899103885076,132.78448030889638,140.46857589209569,49.70429104820709,-50.2957089517929,0.342568207776651,0.6629084603517357,-0.005476150113722156,375842400.0,1.0
604,ABBV,2022-07-26,137.19485473632812,139.64103029232544,136.70380745822595,137.44947389915203,4900600.0,0.5910491943359375,0.0,0.5910491943359375,56.85029280066859,132.78448030889638,140.46857589209569,57.39614219628783,-42.60385780371217,0.40527252426892346,0.6113812731351733,0.0008622516768601596,380743000.0,1.0
605,ABBV,2022-07-27,137.4495086669922,137.76778963888304,135.43073202559356,135.9490729439803,4145800.0,0.2546539306640625,0.0,0.2546539306640625,58.35077246650834,132.78448030889638,140.46857589209569,60.71018127748879,-39.2898187225112,0.4700956211262053,0.5831241427333798,0.004719494939422697,384888800.0,1.0
606,ABBV,2022-07-28,136.1763916015625,138.59528776418685,133.3300959712675,137.71320919267123,6572300.0,-1.2731170654296875,1.2731170654296875,0.0,48.60158247774922,132.78448030889638,140.46857589209569,44.14197163401089,-55.85802836598911,0.41396653656556737,0.5492926214998173,-0.025192100745683343,378316500.0,-1.0
607,ABBV,2022-07-29,130.50201416015625,133.0391317726791,126.44628361661522,132.25708302258667,17754700.0,-5.67437744140625,5.67437744140625,0.0,26.140418798142463,126.44628361661522,140.46857589209569,28.923448918782885,-71.0765510812171,-0.08738369921738354,0.42195735735637707,-0.040516147561121985,360561800.0,-1.0
608,ABBV,2022-08-01,127.51021575927734,129.89272994963883,126.53719576507274,128.68328180414147,8523900.0,-2.9917984008789062,2.9917984008789062,0.0,20.403811126936517,126.44628361661522,140.46857589209569,7.587433792993521,-92.41256620700648,-0.7178456230579968,0.19399676127350224,-0.06357680420804446,352037900.0,-1.0
609,ABBV,2022-08-02,127.66478729248047,129.89271193543496,127.40107954013808,128.38317410974025,5197100.0,0.154571533203125,0.0,0.154571533203125,21.43167405739355,126.44628361661522,140.46857589209569,8.689760931569932,-91.31023906843006,-1.1912862032125417,-0.08305983162370663,-0.049427956384280325,357235000.0,1.0
610,ABBV,2022-08-03,128.4013671875,130.0564056703026,127.90121743304293,128.87423730768703,5474200.0,0.7365798950195312,0.0,0.7365798950195312,26.640474239379472,126.44628361661522,140.46857589209569,13.942681642026972,-86.05731835797302,-1.4898810113866432,-0.3644240675762941,-0.04433166342315231,362709200.0,1.0
611,ABBV,2022-08-04,126.32804870605469,129.65630329132324,126.11890018997565,129.21071274552304,7071700.0,-2.0733184814453125,2.0733184814453125,0.0,21.920543902383045,126.11890018997565,140.46857589209569,1.457513886868816,-98.54248611313119,-1.8722370389729406,-0.6659866618556235,-0.06432286884018457,355637500.0,-1.0
612,ABBV,2022-08-05,125.52781677246094,127.22832627155672,125.44597785357959,126.44627755893005,5371100.0,-0.80023193359375,0.80023193359375,0.0,20.31744438752027,125.44597785357959,139.64103029232544,0.5765312895777941,-99.4234687104222,-2.2143038582634347,-0.975650101137186,-0.0810811142895026,350266400.0,-1.0
613,ABBV,2022-08-08,127.61933135986328,128.03764225324136,125.28228791146084,125.5278046443839,4854600.0,2.0915145874023438,0.0,2.0915145874023438,34.715725965234,125.28228791146084,139.64103029232544,16.27610125185432,-83.72389874814567,-2.290226226994406,-1.2385653263086303,-0.06979506188382822,355121000.0,1.0
614,ABBV,2022-08-09,127.5374984741211,129.3471264423771,127.20104035152764,127.928515873275,3819700.0,-0.0818328857421875,0.0818328857421875,0.0,34.4348205527413,125.28228791146084,139.64103029232544,15.706184447362842,-84.29381555263716,-2.3301380996263674,-1.456879880972178,-0.0721138277539104,351301300.0,-1.0
615,ABBV,2022-08-10,128.16494750976562,128.27406605403525,126.40079037364653,128.1376678736982,4075300.0,0.6274490356445312,0.0,0.6274490356445312,38.8148627159227,125.28228791146084,139.64103029232544,20.075989399645508,-79.92401060035449,-2.2848008904446715,-1.622464082866677,-0.058831373027106615,355376600.0,1.0
616,ABBV,2022-08-11,129.2016143798828,129.92000125067548,127.00096920677898,127.51929616404358,5972800.0,1.0366668701171875,0.0,1.0366668701171875,45.72679078071006,125.28228791146084,139.64103029232544,27.29575031337788,-72.70424968662212,-2.1405455957153094,-1.7260803854364037,-0.00996459547879125,361349400.0,1.0
617,ABBV,2022-08-12,129.6744842529297,130.12006088835722,127.55567799193228,129.0288338286933,5208700.0,0.472869873046875,0.0,0.472869873046875,48.772621321562255,125.28228791146084,139.64103029232544,30.58900441951083,-69.41099558048917,-1.9654095704197232,-1.773946222433068,0.016973294890647805,366558100.0,1.0
618,ABBV,2022-08-15,129.39259338378906,130.2928631446225,127.6920977112554,130.13827389036553,4513200.0,-0.281890869140625,0.281890869140625,0.0,46.959885432809514,125.28228791146084,138.59528776418685,30.874374805063816,-69.12562519493619,-1.8282839268241844,-1.7848137633112913,0.013533928406978646,362044900.0,-1.0
619,ABBV,2022-08-16,129.6290283203125,130.9294040277713,129.20162880965108,129.22890844856934,3852300.0,0.2364349365234375,0.0,0.2364349365234375,48.801481495054404,125.28228791146084,138.59528776418685,32.65034520346372,-67.34965479653627,-1.6811532546910541,-1.7640816615872437,0.009561121970140585,365897200.0,1.0
620,ABBV,2022-08-17,128.61962890625,129.8199745417437,127.81030064516776,128.60143785664556,3605200.0,-1.0093994140625,1.0093994140625,0.0,41.67374327141125,125.28228791146084,133.0391317726791,43.024470448281136,-56.975529551718864,-1.6272433849998151,-1.736714006269758,0.018139916065097017,362292000.0,-1.0
621,ABBV,2022-08-18,128.4832000732422,128.74692169310728,127.14645642950109,128.6650827941299,3525200.0,-0.1364288330078125,0.1364288330078125,0.0,40.74565128738968,125.28228791146084,130.9294040277713,56.682244456355434,-43.317755543644566,-1.5773454351967473,-1.704840292055156,0.023543652528732695,358766800.0,-1.0
622,ABBV,2022-08-19,128.99246215820312,130.3655880017085,128.63781302639953,128.9288004258695,4530700.0,0.5092620849609375,0.0,0.5092620849609375,45.93189307280729,125.28228791146084,130.9294040277713,65.70033571695559,-34.299664283044415,-1.4796512576596115,-1.659802485176047,0.01075958307968139,363297500.0,1.0
623,ABBV,2022-08-22,127.61933135986328,129.72904912523882,127.27378466606974,129.10158972302443,4023500.0,-1.3731307983398438,1.3731307983398438,0.0,36.10140454274841,125.28228791146084,130.9294040277713,41.38472452607086,-58.61527547392913,-1.495785612360919,-1.6269991106130215,0.0006416378455063043,359274000.0,-1.0
624,ABBV,2022-08-23,126.4189682006836,128.0830952052684,125.90062741820643,126.99185437388563,3768100.0,-1.2003631591796875,1.2003631591796875,0.0,29.69162152527315,125.28228791146084,130.9294040277713,20.128509239250416,-79.87149076074958,-1.58713596435652,-1.6190264813617214,-0.01362290815863676,355505900.0,-1.0
625,ABBV,2022-08-24,125.40960693359375,126.81911507879747,125.218635584597,126.44627484428881,5018900.0,-1.0093612670898438,1.0093612670898438,0.0,25.32838623046844,125.218635584597,130.9294040277713,3.344056949551319,-96.65594305044868,-1.7211385809373496,-1.6394489012768474,-0.02934953610672142,350487000.0,-1.0
626,ABBV,2022-08-25,126.70087432861328,126.91002282059694,125.19133645009529,126.19163597819862,3301200.0,1.2912673950195312,0.0,1.2912673950195312,38.63866053073237,125.19133645009529,130.9294040277713,26.307425942330365,-73.69257405766963,-1.7035051854257688,-1.6522601581066316,-0.02293134182447476,353788200.0,1.0
627,ABBV,2022-08-26,123.99102783203125,127.17378234604752,123.90008643849025,126.30079214546274,3838800.0,-2.7098464965820312,2.7098464965820312,0.0,26.989348436660592,123.90008643849025,130.9294040277713,1.2937442701362238,-98.70625572986378,-1.8864467734511834,-1.6990974811755422,-0.041745554444034716,349949400.0,-1.0
628,ABBV,2022-08-29,123.40901184082031,124.3274586604132,122.54511041936041,123.85458849430442,3835800.0,-0.5820159912109375,0.5820159912109375,0.0,25.112994136031958,122.54511041936041,130.9294040277713,10.303806877579493,-89.69619312242051,-2.0547077346109717,-1.770219531862628,-0.04798320684872037,346113600.0,-1.0
629,ABBV,2022-08-30,123.26353454589844,124.11833366652453,122.66335466855993,122.89069426976015,4337100.0,-0.145477294921875,0.145477294921875,0.0,24.619357517860834,122.54511041936041,130.9294040277713,8.568689982628008,-91.431310017372,-2.1747256766004597,-1.8511207608101945,-0.041642900122621174,341776500.0,-1.0
630,ABBV,2022-08-31,122.27232360839844,123.7090975174768,122.00860192995655,123.39083043663804,5789600.0,-0.9912109375,0.9912109375,0.0,21.324040854624457,122.00860192995655,130.9294040277713,2.956255228512287,-97.04374477148772,-2.3230445871152767,-1.945505526071211,-0.04833998889584956,335986900.0,-1.0
631,ABBV,2022-09-01,125.90062713623047,126.02793671617951,121.9449276962899,122.4359749687495,4521000.0,3.6283035278320312,0.0,3.6283035278320312,49.738580381582835,121.9449276962899,130.9294040277713,44.0281580583599,-55.9718419416401,-2.1233381006874055,-1.9810720409944502,-0.023969113933034802,340507900.0,1.0
632,ABBV,2022-09-02,123.9273681640625,126.76456208115337,123.49996858351243,126.09164571019187,3601600.0,-1.9732589721679688,1.9732589721679688,0.0,40.54880290294386,121.9449276962899,130.9294040277713,22.06517547189896,-77.93482452810105,-2.100086291713879,-2.0048748911383365,-0.028929498034981238,336906300.0,-1.0
633,ABBV,2022-09-06,125.11861419677734,126.71909380073785,123.89098872860217,124.85490637605612,4810600.0,1.1912460327148438,0.0,1.1912460327148438,47.32770192328157,121.9449276962899,130.3655880017085,37.68928308918031,-62.3107169108197,-1.9629082815982315,-1.9964815692303155,-0.010286067212967653,341716900.0,1.0
634,ABBV,2022-09-07,126.13706970214844,126.43714566820691,123.07252343211337,125.08221096305208,4141700.0,1.0184555053710938,0.0,1.0184555053710938,52.65339245868332,121.9449276962899,130.3655880017085,49.78400569324653,-50.21599430675347,-1.7518189936820363,-1.9475490541206597,0.005800694112213289,345858600.0,1.0
635,ABBV,2022-09-08,127.78303527832031,127.82850596955659,126.08252578089022,126.9827955148238,3988300.0,1.645965576171875,0.0,1.645965576171875,60.164304247300755,121.9449276962899,130.3655880017085,69.33075756866319,-30.66924243133682,-1.4351698019883088,-1.8450732036941897,0.008541069313383831,349846900.0,1.0
636,ABBV,2022-09-09,128.6014404296875,129.28345910859485,127.40109477017742,127.67389114117593,4427000.0,0.8184051513671875,0.0,0.8184051513671875,63.48739447300124,121.9449276962899,129.72904912523882,85.51398888308998,-14.486011116910028,-1.1054417359996904,-1.6971469101552898,0.03718343720726236,354273900.0,1.0
637,ABBV,2022-09-12,129.3471221923828,129.92000845315007,127.60115602128579,128.22860155682082,4938400.0,0.7456817626953125,0.0,0.7456817626953125,66.43138384830561,121.9449276962899,129.92000845315007,92.81654596068554,-7.183454039314456,-0.775025569485905,-1.5127226420214128,0.04811731544550257,359212300.0,1.0
638,ABBV,2022-09-13,125.97339630126953,129.06520877739678,125.02766983379591,127.81030383745157,6195900.0,-3.3737258911132812,3.3737258911132812,0.0,46.75243721203887,121.9449276962899,129.92000845315007,50.513201405695355,-49.486798594304645,-0.7764494352464197,-1.3654680006664144,0.021984293776372787,353016400.0,-1.0
639,ABBV,2022-09-14,126.90094757080078,127.71027586470223,125.73697011161006,126.55538699282965,4673600.0,0.92755126953125,0.0,0.92755126953125,51.326452249056,121.9449276962899,129.92000845315007,62.143820553136194,-37.856179446863806,-0.6947238791104411,-1.2313191763552198,0.0378550421371433,357690000.0,1.0
640,ABBV,2022-09-15,129.59263610839844,130.8566434905962,126.75544287657732,127.30106336379156,6416900.0,2.6916885375976562,0.0,2.6916885375976562,62.199089565164456,121.9449276962899,130.8566434905962,85.81634096763557,-14.183659032364426,-0.4080552110005726,-1.0666663832842904,0.029324786191676777,364106900.0,1.0
641,ABBV,2022-09-16,131.0021514892578,131.72055230026413,128.5468869104125,130.4019716947805,13887500.0,1.409515380859375,0.0,1.409515380859375,66.69433062725088,121.9449276962899,131.72055230026413,92.65110067018882,-7.348899329811174,-0.06636707641858663,-0.8666065219111496,0.057088143079334186,377994400.0,1.0
642,ABBV,2022-09-19,129.7290496826172,130.82027679408017,128.61052905834003,130.62021687147964,5042500.0,-1.273101806640625,1.273101806640625,0.0,59.34005514937608,121.9449276962899,131.72055230026413,79.62787342675468,-20.372126573245332,0.10053564360929101,-0.6731780888070614,0.03684851782796206,372951900.0,-1.0
643,ABBV,2022-09-20,128.9197235107422,129.574462563455,127.64661363015358,128.96519419856781,4532900.0,-0.809326171875,0.809326171875,0.0,54.89959030416801,121.9449276962899,131.72055230026413,71.34885081017453,-28.65114918982547,0.16559254566263348,-0.5054239619131224,0.022060555355887912,368419000.0,-1.0
644,ABBV,2022-09-21,127.59205627441406,130.6111323824176,127.573865223869,129.26527215620334,5076100.0,-1.327667236328125,1.327667236328125,0.0,48.08824389330058,121.9449276962899,131.72055230026413,57.76744511883519,-42.2325548811648,0.10876518174478633,-0.38258613318154067,-0.0014945567969197882,363342900.0,-1.0
645,ABBV,2022-09-22,130.0473175048828,131.36589805950786,127.31015418515598,127.50112552174419,6161000.0,2.45526123046875,0.0,2.45526123046875,58.95461579775183,123.07252343211337,131.72055230026413,80.65183614796243,-19.348163852037565,0.2588641237639706,-0.2542960817924384,0.011243086161121463,369503900.0,1.0
646,ABBV,2022-09-23,130.09278869628906,130.42015822049038,128.17404223860734,129.19253291151466,5751600.0,0.04547119140625,0.0,0.04547119140625,59.13739694836432,123.07252343211337,131.72055230026413,81.17763447842029,-18.822365521579712,0.37714032296509004,-0.12800880084093266,0.005764848040431758,375255500.0,1.0
647,ABBV,2022-09-26,128.4104766845703,129.85635288291203,127.41017712085315,129.2016138731526,5697800.0,-1.68231201171875,1.68231201171875,0.0,49.69105946569519,123.07252343211337,131.72055230026413,61.72450779062183,-38.275492209378164,0.3313074373819802,-0.03614555319635006,0.019345992525853895,369557700.0,-1.0
648,ABBV,2022-09-27,128.87425231933594,132.34799361948862,128.48322105641046,129.66538955672846,5598000.0,0.463775634765625,0.0,0.463775634765625,52.12366366287626,125.02766983379591,132.34799361948862,52.54661676383802,-47.45338323616199,0.3286192450416934,0.03680740645125865,0.015549960708009847,375155700.0,1.0
649,ABBV,2022-09-28,131.49322509765625,132.14796423035537,129.69268554487994,131.14766447881297,5226700.0,2.6189727783203125,0.0,2.6189727783203125,63.593880601852064,125.02766983379591,132.34799361948862,88.3233508946287,-11.67664910537129,0.5316890681733639,0.13578373879567973,0.014665871814414366,380382400.0,1.0
650,ABBV,2022-09-29,129.7836151123047,132.08429045562323,128.9742867963828,131.72055269311915,5509400.0,-1.7096099853515625,1.7096099853515625,0.0,53.87242653859054,125.02766983379591,132.34799361948862,64.96905625682963,-35.03094374317037,0.5483510781410814,0.2182972066647601,-0.009301651637782848,374873000.0,-1.0
651,ABBV,2022-09-30,122.04499816894531,129.4198954204647,121.93586572439115,129.31076297591056,15359000.0,-7.738616943359375,7.738616943359375,0.0,29.95545971770413,121.93586572439115,132.34799361948862,1.048128160292267,-98.95187183970774,-0.062169223811906704,0.16220392056942673,-0.05923154091139149,359514000.0,-1.0
652,ABBV,2022-10-03,125.78242492675781,126.21891294994617,123.04524803747317,123.5635888390189,7437500.0,3.7374267578125,0.0,3.7374267578125,43.84749675430894,121.93586572439115,132.34799361948862,36.943065251607294,-63.05693474839271,-0.2416463090628156,0.08143387464297824,-0.024335287871781408,366951500.0,1.0
653,ABBV,2022-10-04,129.1197967529297,129.78362446138686,125.27320095261018,126.59178165701164,6612300.0,3.337371826171875,0.0,3.337371826171875,53.37520391077549,121.93586572439115,132.34799361948862,68.99580086718949,-31.004199132810516,-0.1132793634073721,0.04249122703290817,0.011973633180030419,373563800.0,1.0
654,ABBV,2022-10-05,130.33831787109375,131.37498570701544,128.319541473398,128.64691099398937,4777900.0,1.2185211181640625,0.0,1.2185211181640625,56.48568657942291,121.93586572439115,132.34799361948862,80.69870281423339,-19.30129718576662,0.08578792667088919,0.05115056696050438,0.0022376498938549982,378341700.0,1.0
655,ABBV,2022-10-06,127.5738754272461,130.02915404608038,127.21922622963558,129.84727127749483,5124800.0,-2.7644424438476562,2.7644424438476562,0.0,48.08783057061918,121.93586572439115,132.34799361948862,54.148486838214794,-45.851513161785206,0.02024936438340319,0.04497032644508415,-0.01936243579898611,373216900.0,-1.0
656,ABBV,2022-10-07,126.1825180053711,127.35559766010304,125.0822025354161,126.40985751783978,4648800.0,-1.391357421875,1.391357421875,0.0,44.26593580086611,121.93586572439115,132.34799361948862,40.78563309791337,-59.21436690208664,-0.14232074928919758,0.007512111298227794,-0.017350287427652877,368568100.0,-1.0
657,ABBV,2022-10-10,125.7733383178711,126.93731577688858,124.46386020754996,126.42807737303166,3830800.0,-0.4091796875,0.4091796875,0.0,43.10347298833797,121.93586572439115,132.34799361948862,36.85579578106038,-63.14420421893961,-0.3007097222601658,-0.054132255413450944,-0.024061547948158957,364737300.0,-1.0
658,ABBV,2022-10-11,128.6833038330078,130.65660992113695,125.5096518569093,125.5096518569093,5675100.0,2.9099655151367188,0.0,2.9099655151367188,53.19053668731545,121.93586572439115,132.34799361948862,64.80364221989322,-35.19635778010678,-0.1892427543232742,-0.08115435519541561,-0.02136932349603249,370412400.0,1.0
659,ABBV,2022-10-12,127.29196166992188,130.092786694842,127.24649098309514,128.80149966805445,4528000.0,-1.3913421630859375,1.3913421630859375,0.0,48.451597685309174,121.93586572439115,132.34799361948862,51.44093502782109,-48.55906497217891,-0.21074472972630076,-0.10707243010159266,-0.019198520862797164,365884400.0,-1.0
660,ABBV,2022-10-13,131.28793334960938,131.52676725614492,125.17917343747375,125.57416959253986,5066200.0,3.9959716796875,0.0,3.9959716796875,60.20182494879463,121.93586572439115,132.34799361948862,89.81898531636006,-10.181014683639948,0.09357761418914379,-0.06694242124344536,0.07573383030305902,370950600.0,1.0
661,ABBV,2022-10-14,131.30628967285156,132.7209447803754,130.63570740880354,130.99396522295464,5290500.0,0.0183563232421875,0.0,0.0183563232421875,60.24985145729912,121.93586572439115,132.7209447803754,86.88321986162087,-13.116780138379125,0.3324047115417841,0.012927005313600552,0.04391602999632305,376241100.0,1.0
662,ABBV,2022-10-17,132.6566619873047,133.13432977398503,130.53467211436714,131.03989711885998,4016200.0,1.350372314453125,0.0,1.350372314453125,63.943203696683234,121.93586572439115,133.13432977398503,95.73452408683077,-4.2654759131692295,0.6234538788651207,0.13503238002390464,0.027392122070504676,380257300.0,1.0
663,ABBV,2022-10-18,132.8312225341797,133.99784899455653,131.84830154526387,133.40993822166712,3540400.0,0.174560546875,0.0,0.174560546875,64.4360734340342,121.93586572439115,133.99784899455653,90.32807097931872,-9.67192902068128,0.8583040236256636,0.2796867087442565,0.01912641427175288,383797700.0,1.0
664,ABBV,2022-10-19,131.4808349609375,133.61200580883337,130.7275669948626,133.01491409281445,3333300.0,-1.3503875732421875,1.3503875732421875,0.0,57.429002195915615,121.93586572439115,133.99784899455653,79.13266850697164,-20.867331493028367,0.9247989571409789,0.40870915842360106,0.030625075240577004,380464400.0,-1.0
665,ABBV,2022-10-20,131.297119140625,132.3167783433935,130.8378134459887,131.50840985232384,3880100.0,-0.1837158203125,0.1837158203125,0.0,56.46512045309539,123.04524803747317,133.99784899455653,75.34165752487408,-24.658342475125917,0.9517017147460933,0.5173076696880996,0.04053335767983479,376584300.0,-1.0
666,ABBV,2022-10-21,135.09097290039062,135.7339979944694,130.8377981789407,131.673737809691,5419400.0,3.793853759765625,0.0,3.793853759765625,68.90190695376494,124.46386020754996,135.7339979944694,94.29443449373707,-5.705565506262927,1.2645773750192006,0.6667616107543198,0.07408274843568807,382003700.0,1.0
667,ABBV,2022-10-24,138.60926818847656,139.19717890090993,136.59750705810225,136.6067021425587,5139700.0,3.5182952880859375,0.0,3.5182952880859375,76.18249815461925,124.46386020754996,139.19717890090993,96.00965183290083,-3.9903481670991754,1.775958472288238,0.8886009830611037,0.07713482681754624,387143400.0,1.0
668,ABBV,2022-10-25,137.62635803222656,138.34287375787264,135.30225844065026,135.9820358800387,5229400.0,-0.98291015625,0.98291015625,0.0,70.83660735254946,124.46386020754996,139.19717890090993,89.33830930168294,-10.661690698317065,2.0779655477436165,1.1264738959976064,0.08118655904685168,381914000.0,-1.0
669,ABBV,2022-10-26,140.097412109375,140.446488908198,138.43472780659704,138.71949508273292,4727900.0,2.4710540771484375,0.0,2.4710540771484375,75.76895190615039,124.46386020754996,140.446488908198,97.81589871502895,-2.1841012849710513,2.4880213817020262,1.3987833931384905,0.06710044506761093,386641900.0,1.0
670,ABBV,2022-10-27,141.0068359375,141.4569605250118,139.6840334097803,141.24566983176754,6850400.0,0.909423828125,0.0,0.909423828125,77.39262113634922,124.46386020754996,141.4569605250118,97.35113322994243,-2.6488667700575728,2.853483307625851,1.689723376035963,0.07387723991605633,393492300.0,1.0
671,ABBV,2022-10-28,135.59622192382812,136.8547149878251,130.75513618496646,134.05294756715955,10812200.0,-5.410614013671875,5.410614013671875,0.0,53.008811516987734,125.17917343747375,141.4569605250118,63.99548311041286,-36.00451688958714,2.6756796153629807,1.8869146239013666,0.022159158028601356,382680100.0,-1.0
672,ABBV,2022-10-31,134.48471069335938,134.83378752981906,132.3535394178277,133.35482253442188,8604800.0,-1.11151123046875,1.11151123046875,0.0,49.3251033579637,125.17917343747375,141.4569605250118,57.16709037808808,-42.832909621911924,2.417215090329165,1.9929747171869265,0.01244803840267461,374075300.0,-1.0
673,ABBV,2022-11-01,134.9531707763672,135.67886743553322,132.78524784762214,134.72351798313952,6351200.0,0.4684600830078125,0.0,0.4684600830078125,50.98164561457192,125.17917343747375,141.4569605250118,60.04500050486726,-39.95499949513273,2.2245378184733227,2.039287337444206,0.026409444513044944,380426500.0,1.0
674,ABBV,2022-11-02,132.75772094726562,136.02797522684423,132.7209686424966,135.06343047166806,5345000.0,-2.1954498291015625,2.1954498291015625,0.0,43.32337420358701,130.53467211436714,141.4569605250118,20.35332477333178,-79.64667522666822,1.8730933847152471,2.0060485468984144,0.011124401024185993,375081500.0,-1.0
675,ABBV,2022-11-03,132.6658172607422,133.5844283876136,131.38894835506667,132.28000226948342,3850700.0,-0.0919036865234375,0.0919036865234375,0.0,43.011300767173026,130.53467211436714,141.4569605250118,19.511892254173347,-80.48810774582665,1.5690680398577115,1.9186524454902738,-0.017952018462674246,371230800.0,-1.0
676,ABBV,2022-11-04,133.45584106445312,133.73142724238986,131.43489912107577,133.52015057995965,4623700.0,0.7900238037109375,0.0,0.7900238037109375,46.81150863406154,130.7275669948626,141.4569605250118,25.428036187918522,-74.57196381208148,1.3760122692270897,1.8101244102376368,-0.037179527685089364,375854500.0,1.0
677,ABBV,2022-11-07,136.04635620117188,136.68938138844788,132.9230689792776,133.45586528213423,4304000.0,2.59051513671875,0.0,2.59051513671875,57.527262428386244,130.7275669948626,141.4569605250118,49.5721327711923,-50.4278672288077,1.4157274767136983,1.731245023532849,-0.011480372318540266,380158500.0,1.0
678,ABBV,2022-11-08,136.44134521484375,139.28904605921252,135.9177440244568,136.71693142831447,4637500.0,0.394989013671875,0.0,0.394989013671875,58.98116454739429,130.75513618496646,141.4569605250118,53.13308132520892,-46.86691867479109,1.4622188286646178,1.6774397845592026,-0.02609660549387549,384796000.0,1.0
679,ABBV,2022-11-09,135.60540771484375,138.31532250504998,135.07261143129767,136.49646187666596,4573700.0,-0.8359375,0.8359375,0.0,54.43118539983798,130.75513618496646,141.4569605250118,45.32191312212048,-54.678086877879515,1.4152957416898175,1.6250109759853257,-0.038306144427284194,380222300.0,-1.0
680,ABBV,2022-11-10,137.53451538085938,138.3980124365738,135.72484959819815,138.3980124365738,5607700.0,1.929107666015625,0.0,1.929107666015625,62.19649382791003,130.75513618496646,141.4569605250118,63.34788331859498,-36.652116681405026,1.5162928435804588,1.6032673495043523,0.014294597810550425,385830000.0,1.0
681,ABBV,2022-11-11,137.93870544433594,138.2694061431905,133.88762538759212,137.36915678598143,6786400.0,0.4041900634765625,0.0,0.4041900634765625,63.69227177955656,130.75513618496646,141.4569605250118,67.12471660078702,-32.875283399212975,1.6103850185745898,1.6046908833184002,0.025683177910476918,392616400.0,1.0
682,ABBV,2022-11-14,139.3900909423828,141.96219150235714,138.6919373473354,138.6919373473354,7077100.0,1.451385498046875,0.0,1.451385498046875,68.80613681894187,130.75513618496646,141.96219150235714,77.04927398740467,-22.95072601259532,1.7815320328036535,1.640059113215451,0.03287747994723378,399693500.0,1.0
683,ABBV,2022-11-15,140.58425903320312,140.9333357923697,137.75494872812087,140.9057785763192,5909500.0,1.1941680908203125,0.0,1.1941680908203125,72.48527390349261,130.75513618496646,141.96219150235714,87.70477676668736,-12.295223233312633,1.9905804867203187,1.7101633879164246,0.05895354356863636,405603000.0,1.0
684,ABBV,2022-11-16,139.50950622558594,143.93721981895632,138.92159550124808,140.95173282474596,7358700.0,-1.0747528076171875,1.0747528076171875,0.0,64.57596164092692,130.75513618496646,143.93721981895632,66.41112500641725,-33.58887499358275,2.045944943321217,1.7773196989973832,0.05158592549422969,398244300.0,-1.0
685,ABBV,2022-11-17,139.77589416503906,140.61183378454155,137.76413324164338,138.68274451136594,5069500.0,0.266387939453125,0.0,0.266387939453125,65.64796293663944,131.38894835506667,143.93721981895632,66.83745912022728,-33.16254087977272,2.087256362399984,1.8393070316779034,0.0473568863691296,403313800.0,1.0
686,ABBV,2022-11-18,142.36636352539062,142.97265029709206,141.16298506503756,141.16298506503756,5691100.0,2.5904693603515625,0.0,2.5904693603515625,74.3556190395976,131.38894835506667,143.93721981895632,87.48149258576233,-12.518507414237684,2.302483589998019,1.9319423433419267,0.0464548077632696,409004900.0,1.0
687,ABBV,2022-11-21,144.32302856445312,145.71932172962556,141.86114287804656,142.75219700152206,6492100.0,1.9566650390625,0.0,1.9566650390625,78.99585191636638,131.38894835506667,145.71932172962556,90.25640764077149,-9.743592359228517,2.6009570211182904,2.0657452788971993,0.0577660923615102,415497000.0,1.0
688,ABBV,2022-11-22,146.78489685058594,146.86758252233716,144.73639752899248,144.85582148615813,5351100.0,2.4618682861328125,0.0,2.4618682861328125,83.3655564294514,131.38894835506667,146.86758252233716,99.46580770074624,-0.5341922992537674,3.001551543868487,2.252906531891457,0.08244132239365287,420848100.0,1.0
689,ABBV,2022-11-23,146.41744995117188,147.8413002248651,145.89384881539047,146.931870020324,3221100.0,-0.3674468994140625,0.3674468994140625,0.0,80.48203215060754,131.43489912107577,147.8413002248651,91.32137350119784,-8.678626498802172,3.251889932464593,2.4527032120060843,0.06458694783425067,417627000.0,-1.0
690,ABBV,2022-11-25,146.62875366210938,147.66678907538733,146.27969084617467,146.60119644024343,1661900.0,0.2113037109375,0.0,0.2113037109375,80.9199344893118,132.9230689792776,147.8413002248651,91.87204875166165,-8.127951248338354,3.427821559360126,2.647726881476893,0.06299934590353429,419288900.0,1.0
691,ABBV,2022-11-28,145.5355682373047,147.64837683769463,144.9844099177865,146.9777945746782,3902800.0,-1.0931854248046875,1.0931854248046875,0.0,71.36238340410301,133.88762538759212,147.8413002248651,83.47580824084162,-16.524191759158395,3.4393905601130825,2.806059617204131,0.04408833693538594,415386100.0,-1.0
692,ABBV,2022-11-29,145.32431030273438,146.45419831934672,144.41489405246696,145.42535811019704,3689000.0,-0.2112579345703125,0.2112579345703125,0.0,69.53117498056214,133.88762538759212,147.8413002248651,81.961813275114,-18.038186724885996,3.3924067732146455,2.9233290484062344,0.03371679946338624,411697100.0,-1.0
693,ABBV,2022-11-30,148.061767578125,148.061767578125,143.72593499206272,145.86628705807183,12342500.0,2.737457275390625,0.0,2.737457275390625,77.97960151268211,133.88762538759212,148.061767578125,100.0,-0.0,3.535308867861403,3.0457250122972686,0.06130235554493413,424039600.0,1.0
694,ABBV,2022-12-01,148.4751434326172,149.91735583168105,146.95942643333862,147.8964138495385,5827800.0,0.4133758544921875,0.0,0.4133758544921875,78.99444696063,133.88762538759212,149.91735583168105,91.00289050964243,-8.997109490357575,3.6399566299189132,3.164571335821598,0.06223712121137681,429867400.0,1.0
695,ABBV,2022-12-02,150.33993530273438,150.4317880266173,147.44630117093658,147.6392157198151,4304900.0,1.8647918701171875,0.0,1.8647918701171875,83.05850298380733,137.75494872812087,150.4317880266173,99.27542882164775,-0.7245711783522514,3.8292229558716997,3.2975016598316187,0.05600741340788473,434172300.0,1.0
696,ABBV,2022-12-05,150.59713745117188,151.74540156615654,149.63259279120555,149.63259279120555,4859400.0,0.2572021484375,0.0,0.2572021484375,83.56455952771424,137.75494872812087,151.74540156615654,91.79251645191286,-8.207483548087149,3.9543882207428567,3.4288789720138664,0.04347268034163232,439031700.0,1.0
697,ABBV,2022-12-06,150.39505004882812,151.01051796600288,148.4016651185138,150.6798173221735,5480400.0,-0.20208740234375,0.20208740234375,0.0,81.3612405279768,137.76413324164338,151.74540156615654,90.34170945020155,-9.658290549798455,3.9912669890932193,3.541356575429737,0.024594854618571693,433551300.0,-1.0
698,ABBV,2022-12-07,151.9383087158203,152.05773267439488,149.97248102588966,150.36749118746127,4637800.0,1.5432586669921875,0.0,1.5432586669921875,84.87517067325687,137.76413324164338,152.05773267439488,99.16449345641428,-0.8355065435857326,4.097785040420149,3.65264226842782,0.03770628956104316,438189100.0,1.0
699,ABBV,2022-12-08,152.48033142089844,152.70078921512862,150.90949955251122,151.93833997065056,4274400.0,0.542022705078125,0.0,0.542022705078125,85.94871234211669,141.16298506503756,152.70078921512862,98.08925692131423,-1.9107430786857769,4.177779227586569,3.75766966025957,0.039907437065675566,442463500.0,1.0
700,ABBV,2022-12-09,149.78875732421875,154.09704659236593,149.55910449770255,153.18761635327917,4644800.0,-2.6915740966796875,2.6915740966796875,0.0,61.099897804491334,141.86114287804656,154.09704659236593,64.78977467675479,-35.21022532324521,3.9781302528098763,3.8017617787696314,0.02922439605951843,437818700.0,-1.0
701,ABBV,2022-12-12,151.86483764648438,152.02099989656492,149.50399970944432,149.92656710493642,4109400.0,2.076080322265625,0.0,2.076080322265625,69.06078265576436,143.72593499206272,154.09704659236593,78.47666641812732,-21.52333358187267,3.941988543261772,3.8298071316680597,0.0450064227390794,441928100.0,1.0
702,ABBV,2022-12-13,151.37796020507812,153.867403164002,151.2677313270244,153.3621641114274,5050400.0,-0.48687744140625,0.48687744140625,0.0,65.43703758665174,143.72593499206272,154.09704659236593,73.78211235130951,-26.217887648690503,3.829910216600382,3.8298277486545245,0.022397359434489506,436877700.0,-1.0
703,ABBV,2022-12-14,151.44227600097656,152.47111628381595,149.57749597988138,151.20344208300244,4485400.0,0.0643157958984375,0.0,0.0643157958984375,65.71127291800994,143.72593499206272,154.09704659236593,74.40225605795476,-25.59774394204523,3.703584466135595,3.804579092150739,0.019984035709694092,441363100.0,1.0
704,ABBV,2022-12-15,149.8255157470703,151.21261382981564,148.76910429179827,150.55121254107564,5268300.0,-1.61676025390625,1.61676025390625,0.0,53.417806004172526,143.72593499206272,154.09704659236593,58.813182135936785,-41.18681786406322,3.4334328810879526,3.7303498499381815,-0.0034217093058354076,436094800.0,-1.0
705,ABBV,2022-12-16,147.4187469482422,150.0276138603015,147.4187469482422,148.86097350979347,18905500.0,-2.406768798828125,2.406768798828125,0.0,40.426851288652664,143.72593499206272,154.09704659236593,35.60671313257786,-64.39328686742213,2.9906552634821253,3.5824109326469706,-0.021105251777844836,417189300.0,-1.0
706,ABBV,2022-12-19,148.3465576171875,149.02632107130736,147.03293604778486,147.6943373663699,4033400.0,0.9278106689453125,0.0,0.9278106689453125,46.242123198769725,143.72593499206272,154.09704659236593,44.55281943923632,-55.44718056076368,2.68368156785516,3.4026650596886086,-0.013620743707825178,421222700.0,1.0
707,ABBV,2022-12-20,147.5106201171875,148.67726051852023,147.04213334983226,148.4567887367014,4221000.0,-0.8359375,0.8359375,0.0,41.98179704295511,146.95942643333862,154.09704659236593,7.722373446165484,-92.27762655383451,2.3459073725023813,3.191313522251363,-0.02914135767375292,417001700.0,-1.0
708,ABBV,2022-12-21,149.0079345703125,149.48560232026318,147.30849817910638,148.3097810610237,3707200.0,1.497314453125,0.0,1.497314453125,51.26204356211233,147.03293604778486,154.09704659236593,27.958205213007005,-72.041794786993,2.173979371007988,2.9878466920026883,-0.02277275251324662,420708900.0,1.0
709,ABBV,2022-12-22,149.98165893554688,150.0918877973647,148.38327035471355,148.69559480779404,3606000.0,0.973724365234375,0.0,0.973724365234375,56.48487922158537,147.03293604778486,154.09704659236593,41.74230951162002,-58.25769048837998,2.092179269388538,2.8087132074798586,0.0012878243652865162,424314900.0,1.0
710,ABBV,2022-12-23,149.8255157470703,150.4869170358103,149.11818108777123,150.09190686927826,2685100.0,-0.1561431884765625,0.1561431884765625,0.0,55.38668456259721,147.03293604778486,154.09704659236593,39.531936563870204,-60.468063436129796,1.991792505000376,2.645329066983962,-0.013428532443838348,421629800.0,-1.0
711,ABBV,2022-12-27,149.72447204589844,150.47772607952345,148.61294612222238,150.1837777302957,2669200.0,-0.101043701171875,0.101043701171875,0.0,54.59413357805794,147.03293604778486,154.09704659236593,38.101555477189926,-61.89844452281008,1.8823829498449243,2.492739843556155,-0.010922912139519125,418960600.0,-1.0
712,ABBV,2022-12-28,149.0263214111328,151.2861115909342,148.91609253008306,150.37668127158167,2944500.0,-0.698150634765625,0.698150634765625,0.0,49.00378065463159,147.03293604778486,154.09704659236593,28.218490505886756,-71.78150949411324,1.719518627222243,2.3380956002893725,-0.01595297332845269,416016100.0,-1.0
713,ABBV,2022-12-29,149.3294677734375,150.54204155630543,148.98958603895073,149.6969207456237,3112500.0,0.3031463623046875,0.0,0.3031463623046875,51.49237652769717,147.03293604778486,154.09704659236593,32.50984977032003,-67.49015022967997,1.5965053363800905,2.189777547507516,-0.003310837751229423,419128600.0,1.0
714,ABBV,2022-12-30,148.45677185058594,149.59585490173927,146.81246380102283,149.02630636771462,3680400.0,-0.8726959228515625,0.8726959228515625,0.0,44.309879460791414,146.81246380102283,153.867403164002,23.307188977294683,-76.69281102270531,1.4123168401779367,2.0342854060416,0.007041335812657534,415448200.0,-1.0
715,ABBV,2023-01-03,149.1641082763672,149.7520189512266,147.72188179858463,148.851769779648,4937500.0,0.70733642578125,0.0,0.70733642578125,50.73631818469507,146.81246380102283,153.867403164002,33.333305282319216,-66.66669471768078,1.308340532786417,1.8890964313905634,0.0055110861506433295,420385700.0,1.0
716,ABBV,2023-01-04,150.36749267578125,150.9094700030054,148.36491266328485,149.18247619623378,4440400.0,1.2033843994140625,0.0,1.2033843994140625,59.834791043444724,146.81246380102283,152.47111628381595,62.82465455457083,-37.17534544542917,1.3079642265749385,1.7728699904274385,0.019367233059722322,424826100.0,1.0
717,ABBV,2023-01-05,150.1837921142578,151.102403571033,149.12738052882727,149.81633912140867,3516000.0,-0.1837005615234375,0.1837005615234375,0.0,57.949638989157854,146.81246380102283,151.2861115909342,75.35971698169304,-24.64028301830697,1.2781096486914407,1.673917922080239,0.007891241143205496,421310100.0,-1.0
718,ABBV,2023-01-06,152.99473571777344,154.42776729882513,150.76250266505988,151.42390401276035,5099100.0,2.810943603515625,0.0,2.810943603515625,72.97995763593919,146.81246380102283,154.42776729882513,81.18221313877704,-18.817786861222956,1.464388775146432,1.6320120926934776,0.020089634983444293,426409200.0,1.0
719,ABBV,2023-01-09,148.50271606445312,152.74669606918488,147.78620032383338,152.3976192664071,7833000.0,-4.4920196533203125,4.4920196533203125,0.0,43.98829951173805,146.81246380102283,154.42776729882513,22.19546816378474,-77.80453183621526,1.2353080183987686,1.552671277834536,-0.008828934617854278,418576200.0,-1.0
720,ABBV,2023-01-10,146.64710998535156,149.200848323521,145.41617418546483,149.02630993070645,5936200.0,-1.8556060791015625,1.8556060791015625,0.0,36.98521128797974,145.41617418546483,154.42776729882513,13.659469356886412,-86.3405306431136,0.8937256526037629,1.4208821527883815,-0.02055350083053553,412640000.0,-1.0
721,ABBV,2023-01-11,144.37814331054688,146.37152824577376,142.43987281327796,146.26129936985788,7492000.0,-2.2689666748046875,2.2689666748046875,0.0,30.2014512934129,142.43987281327796,154.42776729882513,16.168564876890866,-83.83143512310913,0.43491904263635206,1.2236895307579756,-0.031190316291593745,405148000.0,-1.0
722,ABBV,2023-01-12,141.16024780273438,143.97936619813478,140.69657598999385,143.73826194956038,7665100.0,-3.2178955078125,3.2178955078125,0.0,23.229257800567538,140.69657598999385,154.42776729882513,3.3767777486452757,-96.62322225135472,-0.1861993850853878,0.9417117475893029,-0.05470601410766063,397482900.0,-1.0
723,ABBV,2023-01-13,142.44000244140625,142.63473670042603,140.3441965576729,141.03970435445683,6019300.0,1.279754638671875,0.0,1.279754638671875,30.58302664027326,140.3441965576729,154.42776729882513,14.881211038401009,-85.118788961599,-0.5686200124367531,0.6396453955840916,-0.04052876358671775,403502200.0,1.0
724,ABBV,2023-01-17,141.72593688964844,143.83101101386177,141.4941009687042,142.6254613949234,8507000.0,-0.7140655517578125,0.7140655517578125,0.0,28.806529739438716,140.3441965576729,154.42776729882513,9.811008567153355,-90.18899143284665,-0.9187198070837326,0.3279723550505267,-0.04986569136951835,394995200.0,-1.0
725,ABBV,2023-01-18,138.35968017578125,141.34572808580006,138.23913511429382,141.06752213980818,6190800.0,-3.3662567138671875,3.3662567138671875,0.0,21.890017411638738,138.23913511429382,154.42776729882513,0.7446278358379027,-99.2553721641621,-1.4510780757101713,-0.027837731101613014,-0.07985643895712857,388804400.0,-1.0
726,ABBV,2023-01-19,137.9052734375,139.60229977898095,136.6255347372287,138.12782684614515,7169900.0,-0.45440673828125,0.45440673828125,0.0,21.100898243895173,136.6255347372287,154.42776729882513,7.18864162594979,-92.81135837405022,-1.8878803555999184,-0.39984625600127427,-0.08175661636920506,381634500.0,-1.0
727,ABBV,2023-01-20,138.7213592529297,138.83265013392096,136.45863805807258,138.5729808450372,7059000.0,0.8160858154296875,0.0,0.8160858154296875,26.58517340220827,136.45863805807258,154.42776729882513,12.592269578235523,-87.40773042176447,-2.1434891952444843,-0.7485748438499165,-0.09329325220165474,388693500.0,1.0
728,ABBV,2023-01-23,137.7569122314453,139.50030880035948,137.2932403721339,138.97173023881842,7616400.0,-0.964447021484375,0.964447021484375,0.0,24.28347475973476,136.45863805807258,154.42776729882513,7.225025520036608,-92.77497447996339,-2.3962612485859154,-1.0781121247971164,-0.07236099189151479,381077100.0,-1.0
729,ABBV,2023-01-24,136.9593963623047,138.05365516056733,135.80021671153042,137.32105984734056,5171400.0,-0.797515869140625,0.797515869140625,0.0,22.430550132706912,135.80021671153042,154.42776729882513,6.222931165007301,-93.77706883499269,-2.6306137101542504,-1.3886124418685433,-0.06606140157835072,375905700.0,-1.0
730,ABBV,2023-01-25,137.0521240234375,137.22832159666527,135.85585683437156,136.67192384715602,5744300.0,0.0927276611328125,0.0,0.0927276611328125,23.216567827001796,135.80021671153042,154.42776729882513,6.720729631307316,-93.27927036869268,-2.776847606390618,-1.6662594747729584,-0.05074188598859897,381650000.0,1.0
731,ABBV,2023-01-26,136.6904754638672,137.89602527802828,136.42155197808563,137.1726982195604,4577800.0,-0.3616485595703125,0.3616485595703125,0.0,22.204057870446178,135.80021671153042,154.42776729882513,4.779258272120767,-95.22074172787923,-2.888622793591196,-1.9107321385366063,-0.03166452601523839,377072200.0,-1.0
732,ABBV,2023-01-27,135.65184020996094,136.9501157768575,135.40145343986575,136.6070031234939,4591500.0,-1.03863525390625,1.03863525390625,0.0,19.400336934185248,135.40145343986575,152.74669606918488,1.4435472333604291,-98.55645276663957,-3.026131262010466,-2.1338119632313783,-0.0476562911759123,372480700.0,-1.0
733,ABBV,2023-01-30,135.067626953125,136.43082355332314,134.70596341532615,135.27164373343658,4573400.0,-0.5842132568359375,0.5842132568359375,0.0,17.930869272014718,134.70596341532615,149.200848323521,2.4951114830472143,-97.50488851695278,-3.1459838972203613,-2.336246350029175,-0.046980179370468944,367907300.0,-1.0
734,ABBV,2023-01-31,137.01502990722656,137.10776993608678,133.91770538522243,135.04906581663693,5628700.0,1.9474029541015625,0.0,1.9474029541015625,36.445973293069606,133.91770538522243,146.37152824577376,24.870471956166973,-75.12952804383303,-3.0486854823456895,-2.478734176492478,-0.009718512407996038,373536000.0,1.0
735,ABBV,2023-02-01,135.94859313964844,136.7275584576857,134.69667347483414,135.9764123188539,5439900.0,-1.066436767578125,1.066436767578125,0.0,31.898741761219156,133.91770538522243,143.97936619813478,20.184418777263108,-79.8155812227369,-3.0227835549162876,-2.58754405217724,-0.014188582126544613,368096100.0,-1.0
736,ABBV,2023-02-02,134.3164825439453,135.3272839647746,133.01820678784753,135.3272839647746,6160800.0,-1.632110595703125,1.632110595703125,0.0,26.13958842646788,133.01820678784753,143.83101101386177,12.00683679238632,-87.99316320761368,-3.098239202827756,-2.6896830823073437,-0.03175341369711493,361935300.0,-1.0
737,ABBV,2023-02-03,134.6503143310547,136.13407004247375,134.18664244000414,135.31800298617895,6553000.0,0.333831787109375,0.0,0.333831787109375,29.158156357155434,133.01820678784753,143.83101101386177,15.094211539320312,-84.90578846067969,-3.0954188504781257,-2.7708302359415002,-0.0225513032345791,368488300.0,1.0
738,ABBV,2023-02-06,134.48338317871094,135.69820112413416,134.28863478166883,135.1510717540818,4297000.0,-0.16693115234375,0.16693115234375,0.0,28.486441367166094,133.01820678784753,141.34572808580006,17.59438779488496,-82.40561220511505,-3.0712501894170714,-2.8309142266366147,-0.018078446965725803,364191300.0,-1.0
739,ABBV,2023-02-07,134.59466552734375,134.89142230666474,133.22220079833932,134.07535531367407,5401900.0,0.1112823486328125,0.0,0.1112823486328125,29.731591996031568,133.01820678784753,139.60229977898095,23.943445841654775,-76.05655415834522,-3.008437402205743,-2.8664188617504407,-0.017930831160803407,369593200.0,1.0
740,ABBV,2023-02-08,134.10321044921875,135.71679403159703,133.97338286099148,134.84508844629426,5753800.0,-0.491455078125,0.491455078125,0.0,27.308669641178795,133.01820678784753,139.50030880035948,16.738453965656692,-83.26154603434331,-2.964145311309892,-2.885964151662331,-0.018927909979597368,363839400.0,-1.0
741,ABBV,2023-02-09,137.8960418701172,142.53276159776166,137.15416388366495,137.71057591104054,12216900.0,3.7928314208984375,0.0,3.7928314208984375,57.876858401423625,133.01820678784753,142.53276159776166,51.267086897087076,-48.73291310291293,-2.593102046276414,-2.827391730585148,0.01654383498729306,376056300.0,1.0
742,ABBV,2023-02-10,141.00262451171875,142.0505133605212,137.9609380467822,138.81409262595776,8956700.0,3.1065826416015625,0.0,3.1065826416015625,69.85658328699384,133.01820678784753,142.53276159776166,83.91793292894255,-16.08206707105745,-2.0250290547261045,-2.6669191954133393,0.04394093309015856,385013000.0,1.0
743,ABBV,2023-02-13,142.560546875,142.60691689127611,140.27000674235447,140.9747970294099,5602600.0,1.55792236328125,0.0,1.55792236328125,74.11615292616749,133.01820678784753,142.60691689127611,99.51641028067442,-0.48358971932558464,-1.4326016613725017,-2.420055688605172,0.040473785770278825,390615600.0,1.0
744,ABBV,2023-02-14,141.5033721923828,142.8109302091631,140.73367522116055,142.73674101493353,4662800.0,-1.0571746826171875,1.0571746826171875,0.0,66.7326803890216,133.01820678784753,142.8109302091631,86.64765703548655,-13.352342964513456,-1.0364562234680932,-2.1433357955777566,0.04085940813693023,385952800.0,-1.0
745,ABBV,2023-02-15,140.0845489501953,142.33800169057182,139.87126384312862,141.53120298098364,5648100.0,-1.4188232421875,1.4188232421875,0.0,57.81382814487633,133.01820678784753,142.8109302091631,72.15911098813078,-27.84088901186923,-0.8274568800597422,-1.8801600124741535,0.04294384648111094,380304700.0,-1.0
746,ABBV,2023-02-16,138.6656951904297,139.56521966513318,137.92381743859343,138.27621255449742,3757500.0,-1.418853759765625,1.418853759765625,0.0,50.089289975298584,133.01820678784753,142.8109302091631,57.67025330552491,-42.32974669447509,-0.7674661630110506,-1.657621242581533,0.02982080568711254,376547200.0,-1.0
747,ABBV,2023-02-17,140.31639099121094,140.39058019474942,137.81256550989787,138.31332494610297,4562400.0,1.65069580078125,0.0,1.65069580078125,57.67972393843836,133.01820678784753,142.8109302091631,74.52660398309251,-25.473396016907472,-0.5800393987309462,-1.442104873811416,0.04337344640377383,381109600.0,1.0
748,ABBV,2023-02-21,140.9562530517578,141.90214765927675,138.9346504250578,138.9346504250578,8466100.0,0.639862060546875,0.0,0.639862060546875,60.37503544502718,133.01820678784753,142.8109302091631,81.0606602718069,-18.939339728193104,-0.3755418048071135,-1.2287922600105556,0.0472647819992662,389575700.0,1.0
749,ABBV,2023-02-22,139.72286987304688,141.09533455058497,139.32411888469696,140.02889498394268,6041700.0,-1.2333831787109375,1.2333831787109375,0.0,52.883962447563135,133.01820678784753,142.8109302091631,68.46576582164542,-31.534234178354577,-0.309432754823149,-1.0449203589730742,0.041905480152215624,383534000.0,-1.0
750,ABBV,2023-02-23,141.02114868164062,142.41216408792957,138.33184373939773,139.93614421261165,5993300.0,1.29827880859375,0.0,1.29827880859375,59.054347677582115,133.22220079833932,142.8109302091631,81.33452879062196,-18.66547120937804,-0.15054521520630715,-0.8660453302197207,0.022662773848628248,389527300.0,1.0
751,ABBV,2023-02-24,141.61465454101562,141.86502713757147,139.94543314660447,140.3070966028818,5621100.0,0.593505859375,0.0,0.593505859375,61.700082465351855,133.22220079833932,142.8109302091631,87.52414822763568,-12.475851772364322,0.023000136126881898,-0.6882362369504001,0.004340557712427584,395148400.0,1.0
752,ABBV,2023-02-27,143.07057189941406,143.50642453080806,141.97631322494615,142.12467744935256,6828800.0,1.4559173583984375,0.0,1.4559173583984375,67.62183627357138,133.22220079833932,143.50642453080806,95.76192970191858,-4.238070298081427,0.274848162073539,-0.49561935714561234,0.0035776028893972356,401977200.0,1.0
753,ABBV,2023-02-28,142.7182159423828,143.1540686933232,141.53121692071585,142.7738684607079,7561700.0,-0.35235595703125,0.35235595703125,0.0,64.82301888860061,133.97338286099148,143.50642453080806,91.73182478661698,-8.268175213383016,0.44092465121931923,-0.308310555472626,0.008585263596038839,394415500.0,-1.0
754,ABBV,2023-03-01,143.98867797851562,144.27615229686597,141.29937242751762,141.6610359490138,5485800.0,1.2704620361328125,0.0,1.2704620361328125,69.9904537667125,137.15416388366495,144.27615229686597,95.96356660988808,-4.036433390111922,0.6673641752134074,-0.11317560933541926,0.02786980475418721,399901300.0,1.0
755,ABBV,2023-03-02,143.163330078125,144.45233730143536,143.00568334147755,143.9515637613623,4567800.0,-0.825347900390625,0.825347900390625,0.0,63.04802836169367,137.81256550989787,144.45233730143536,80.58657339769982,-19.413426602300177,0.7713290503888857,0.06372532260944178,0.03243509421359558,395333500.0,-1.0
756,ABBV,2023-03-03,144.7212677001953,144.82327608175956,142.82021012566685,143.11696692663307,4851200.0,1.5579376220703125,0.0,1.5579376220703125,69.61285462944085,137.81256550989787,144.82327608175956,98.54496373058575,-1.4550362694142458,0.9682728620403509,0.24463483049562368,0.031392460124350485,400184700.0,1.0
757,ABBV,2023-03-06,143.9979248046875,145.09219769988954,143.31168539074244,144.47086498515816,4051900.0,-0.7233428955078125,0.7233428955078125,0.0,63.56316369050493,137.81256550989787,145.09219769988954,84.96801944600321,-15.031980553996787,1.053836553441414,0.40647517508478187,0.021578835185217526,396132800.0,-1.0
758,ABBV,2023-03-07,141.81866455078125,144.35959137032376,141.00261172089503,144.26686549086537,4606900.0,-2.17926025390625,2.17926025390625,0.0,48.815733501505754,137.81256550989787,145.09219769988954,55.031613360783915,-44.968386639216085,0.9350199774076771,0.5121841355493609,0.014999653812139968,391525900.0,-1.0
759,ABBV,2023-03-08,138.73065185546875,142.56985500102044,137.7476554441657,141.68886698380805,5860100.0,-3.0880126953125,3.0880126953125,0.0,35.39064387410927,137.7476554441657,145.09219769988954,13.384039155564361,-86.61596084443563,0.5849373740240367,0.5267347832442961,-0.016242222160186337,385665800.0,-1.0
760,ABBV,2023-03-09,136.64410400390625,139.94544541212036,135.92077702795564,139.16648007650312,5350200.0,-2.0865478515625,2.0865478515625,0.0,29.142140594307435,135.92077702795564,145.09219769988954,7.886749521414013,-92.11325047858598,0.1375419174133583,0.44889621007810854,-0.03509912553343664,380315600.0,-1.0
761,ABBV,2023-03-10,138.83265686035156,139.69507986649134,136.7554014996453,137.09851420314465,6825500.0,2.1885528564453125,0.0,2.1885528564453125,41.61735225443499,135.92077702795564,145.09219769988954,31.749495923862376,-68.25050407613763,-0.03996360468670446,0.35112424712514595,-0.02962115117595232,387141100.0,1.0
762,ABBV,2023-03-13,140.90989685058594,142.1803675622691,138.17423529063248,138.17423529063248,7653800.0,2.077239990234375,0.0,2.077239990234375,51.05467217971654,135.92077702795564,145.09219769988954,54.39854959328003,-45.60145040671997,-0.012873702784190755,0.27832465714327864,-0.01267055561097341,394794900.0,1.0
763,ABBV,2023-03-14,142.67184448242188,142.8016720440413,140.45549344111234,140.90988283170893,6644100.0,1.7619476318359375,0.0,1.7619476318359375,57.74034429169945,135.92077702795564,145.09219769988954,73.60983315404609,-26.39016684595391,0.14905151523785776,0.2524700287621945,-0.00914539611434051,401439000.0,1.0
764,ABBV,2023-03-15,142.8665771484375,143.16333394318025,140.70586449344884,141.12316635468088,6304600.0,0.194732666015625,0.0,0.194732666015625,58.46386936956713,135.92077702795564,145.09219769988954,75.73308835061057,-24.266911649389435,0.28975163929354153,0.2599263508684639,-0.00207282779413942,407743600.0,1.0
765,ABBV,2023-03-16,144.01649475097656,144.59144337805617,141.4291976288316,142.06906711388126,6331200.0,1.1499176025390625,0.0,1.1499176025390625,62.80307733498519,135.92077702795564,145.09219769988954,88.27114154511733,-11.728858454882669,0.48841608496090316,0.30562429768695176,-0.004869864398083901,414074800.0,1.0
766,ABBV,2023-03-17,143.01495361328125,144.7305452031162,140.84497264408287,144.46160759274684,42756400.0,-1.0015411376953125,1.0015411376953125,0.0,56.836046694906294,135.92077702795564,145.09219769988954,77.3509016660308,-22.64909833396921,0.5586038523774448,0.3562202086250504,-0.006826287203371195,371318400.0,-1.0
767,ABBV,2023-03-20,144.77691650390625,144.9809332817481,143.23753647584155,143.29317484249947,4408200.0,1.761962890625,0.0,1.761962890625,63.81488548614875,135.92077702795564,145.09219769988954,96.56235160002961,-3.4376483999703846,0.7477838568433697,0.43453293826871436,0.020859397897275533,375726600.0,1.0
768,ABBV,2023-03-21,145.37966918945312,145.6393242816153,143.83100697900684,145.25910998589882,4675700.0,0.602752685546875,0.0,0.602752685546875,65.98565807475163,135.92077702795564,145.6393242816153,97.3282519970832,-2.6717480029167935,0.9355628910202256,0.5347389288190166,0.04792752895669672,380402300.0,1.0
769,ABBV,2023-03-22,142.50491333007812,145.48169301381117,142.44927496872396,144.36886918615667,4376900.0,-2.874755859375,2.874755859375,0.0,49.6081696368861,135.92077702795564,145.6393242816153,67.74815340475021,-32.251846595249795,0.8426962778351594,0.5963303986222452,0.04289105167687546,376025400.0,-1.0
770,ABBV,2023-03-23,144.01649475097656,145.12930447925527,142.82949582079348,142.90368502269786,4584000.0,1.5115814208984375,0.0,1.5115814208984375,56.20322394359405,135.92077702795564,145.6393242816153,83.30172722031435,-16.698272779685652,0.8809161526155833,0.6532475494209129,0.037338750174890745,380609400.0,1.0
771,ABBV,2023-03-24,146.5388641357422,146.9654343389873,143.35806769783125,143.99793715284164,4678700.0,2.522369384765625,0.0,2.522369384765625,65.01826981238733,135.92077702795564,146.9654343389873,96.13776877604838,-3.8622312239516163,1.1020362202155525,0.7430052835798409,0.039947281283762015,385288100.0,1.0
772,ABBV,2023-03-27,146.0937042236328,147.57745964069994,145.9453400020384,147.2899853893015,3887800.0,-0.445159912109375,0.445159912109375,0.0,62.45833953870674,135.92077702795564,147.57745964069994,87.27120342587922,-12.728796574120778,1.2272082890761453,0.8398458846791018,0.023984127727685767,381400300.0,-1.0
773,ABBV,2023-03-28,146.75216674804688,147.0767427611019,146.01028882545282,146.33486483850785,3532500.0,0.6584625244140625,0.0,0.6584625244140625,64.82221269072144,135.92077702795564,147.57745964069994,92.92000202741413,-7.079997972585876,1.363819219172882,0.9446405515778579,0.02719733108445843,384932800.0,1.0
774,ABBV,2023-03-29,146.5203094482422,148.09679096037834,144.99946629592435,147.4291023422737,3959900.0,-0.2318572998046875,0.2318572998046875,0.0,63.205244689810904,136.7554014996453,148.09679096037834,86.0997497917309,-13.900250208269108,1.436812736282235,1.0430749885187334,0.017385610596862833,380972900.0,-1.0
775,ABBV,2023-03-30,146.4461212158203,147.01180146126777,145.98244934742544,146.5295787560972,3635800.0,-0.074188232421875,0.074188232421875,0.0,62.62846297452905,138.17423529063248,148.09679096037834,83.36446980498214,-16.635530195017868,1.4717093053766348,1.1288018518903138,0.023991670212452743,377337100.0,-1.0
776,ABBV,2023-03-31,147.790771484375,147.9762515577207,146.26992827388347,146.91906608016467,4957300.0,1.3446502685546875,0.0,1.3446502685546875,68.61762891946853,140.45549344111234,148.09679096037834,95.99518962281242,-4.004810377187586,1.5895438546614855,1.2209502524445481,0.020817234219706826,382294400.0,1.0
777,ABBV,2023-04-03,148.7644500732422,148.8108200806081,146.3255320172184,146.75211627478947,4389400.0,0.9736785888671875,0.0,0.9736785888671875,72.32350324468325,140.70586449344884,148.8108200806081,99.42788079629489,-0.57211920370511,1.741422276664224,1.3250446572884835,0.023282353733919514,386683800.0,1.0
778,ABBV,2023-04-04,148.17098999023438,149.979307555051,147.93915404217728,148.84794699652096,4224400.0,-0.5934600830078125,0.5934600830078125,0.0,66.77775031166397,140.84497264408287,149.979307555051,80.20307354129002,-19.796926458709976,1.7932285291425103,1.418681431659289,0.03976057054981785,382459400.0,-1.0
779,ABBV,2023-04-05,149.11688232421875,149.92366688298856,147.45692903761002,148.37500447183098,5743000.0,0.945892333984375,0.0,0.945892333984375,70.88371428869172,140.84497264408287,149.979307555051,90.55842336373398,-9.441576636266023,1.8888376193605154,1.5127126691995345,0.035415301435168356,388202400.0,1.0
780,ABBV,2023-04-06,149.81239318847656,150.40589265236503,148.949956099462,149.11688534094432,5498300.0,0.6955108642578125,0.0,0.6955108642578125,73.64700280410207,142.44927496872396,150.40589265236503,92.54080706794915,-7.459192932050855,1.997702159336967,1.6097105672270213,0.02233898203074669,393700700.0,1.0
781,ABBV,2023-04-10,149.56199645996094,150.28532344130358,148.5697460215109,149.9607616241148,3309500.0,-0.250396728515625,0.250396728515625,0.0,70.8536541142467,142.44927496872396,150.40589265236503,89.39378230854108,-10.606217691458921,2.0402543857122737,1.6958193309240719,0.023740189591052063,390391200.0,-1.0
782,ABBV,2023-04-11,149.65472412109375,150.77680202368205,149.4785265619746,149.7567324895237,2875800.0,0.0927276611328125,0.0,0.0927276611328125,71.3184910529595,142.44927496872396,150.77680202368205,86.52567688843193,-13.47432311156806,2.0577393407609748,1.7682033328914528,0.01977863385165657,393267000.0,1.0
783,ABBV,2023-04-12,150.56353759765625,151.6021581094937,149.85876141464416,150.3409699950583,4005000.0,0.9088134765625,0.0,0.9088134765625,75.70096124700217,142.82949582079348,151.6021581094937,88.16071475616629,-11.839285243833721,2.120486299789718,1.8386599262711059,0.027595001434543853,397272000.0,1.0
784,ABBV,2023-04-13,152.25746154785156,152.41655853772787,150.25469020423952,150.67583097512562,3868500.0,1.6939239501953125,0.0,1.6939239501953125,81.71096582972861,143.35806769783125,152.41655853772787,98.2436700253028,-1.7563299746971888,2.2806097731208013,1.927049895641045,0.039682446238825,401140500.0,1.0
785,ABBV,2023-04-14,151.22799682617188,152.54758364572035,150.61031606634296,152.21066816584235,3473100.0,-1.0294647216796875,1.0294647216796875,0.0,69.63365206126096,144.99946629592435,152.54758364572035,82.51766952743336,-17.482330472566645,2.2979502399770126,2.0012299645082385,0.023257374647105644,397667400.0,-1.0
786,ABBV,2023-04-17,150.84426879882812,151.7988649375719,150.3482563781791,151.53682117875027,4354100.0,-0.38372802734375,0.38372802734375,0.0,65.47164135140366,144.99946629592435,152.54758364572035,77.43391142510177,-22.566088574898227,2.254737825902737,2.051931536787138,0.013980616501872323,393313300.0,-1.0
787,ABBV,2023-04-18,149.35623168945312,150.8910655413964,148.25190645905022,150.67581837078313,4996200.0,-1.488037109375,1.488037109375,0.0,51.65670549652005,144.99946629592435,152.54758364572035,57.71989479795943,-42.28010520204057,2.07648311297811,2.0568418520253324,0.007999148141595525,388317100.0,-1.0
788,ABBV,2023-04-19,150.8723602294922,151.08760740281505,148.3548551091159,148.49523059599733,4826900.0,1.5161285400390625,0.0,1.5161285400390625,61.26540889388845,145.98244934742544,152.54758364572035,74.48302898139872,-25.516971018601275,2.0341059637328556,2.052294674366837,0.01177249603070818,393144000.0,1.0
789,ABBV,2023-04-20,151.36839294433594,151.39646804547505,150.28277476590412,150.84429106900214,3808100.0,0.49603271484375,0.0,0.49603271484375,63.96891924905342,146.26992827388347,152.54758364572035,81.21606505074243,-18.783934949257567,2.0172933600811405,2.0452944115096976,0.010386322004093396,396952100.0,1.0
790,ABBV,2023-04-21,151.9954071044922,152.72538819757122,151.63041655795266,152.16385768890393,4812100.0,0.62701416015625,0.0,0.62701416015625,67.29795812651119,146.3255320172184,152.72538819757122,88.5937891023234,-11.406210897676589,2.0311502177444822,2.0424655727566545,0.01627024713582692,401764200.0,1.0
791,ABBV,2023-04-24,153.55833435058594,153.82037814440122,151.92055349908264,152.14516858534535,4728900.0,1.56292724609375,0.0,1.56292724609375,74.16362188053195,147.45692903761002,153.82037814440122,95.88204777915766,-4.117952220842346,2.143537676083696,2.062679993422063,0.026084109622450447,406493100.0,1.0
792,ABBV,2023-04-25,154.3257293701172,155.54236931294122,153.94203160348528,154.2415040760015,5506200.0,0.76739501953125,0.0,0.76739501953125,76.9099965135157,147.45692903761002,155.54236931294122,84.95270632897977,-15.047293671020226,2.2683794449891934,2.103819883735489,0.0249874028764816,411999300.0,1.0
793,ABBV,2023-04-26,151.42453002929688,152.7908991007565,150.20789005750336,152.248090058562,5192000.0,-2.9011993408203125,2.9011993408203125,0.0,52.54501186002375,148.25190645905022,155.54236931294122,43.51745059030638,-56.48254940969362,2.1089047644367156,2.1048368598757343,-0.005470546468377302,406807300.0,-1.0
794,ABBV,2023-04-27,139.3236541748047,144.00302741133672,137.72331652488646,144.00302741133672,17063000.0,-12.100875854492188,12.100875854492188,0.0,20.812780948145473,137.72331652488646,155.54236931294122,8.981047808506625,-91.01895219149337,0.9946150774410967,1.8827925033888067,-0.07871784921578084,389744300.0,-1.0
795,ABBV,2023-04-28,141.4293670654297,141.68205720963925,137.98535534125273,138.4813677441335,7123800.0,2.105712890625,0.0,2.105712890625,29.376257214019034,137.72331652488646,155.54236931294122,20.798246599435583,-79.20175340056441,0.2782385438341066,1.5618817114778667,-0.06241471292458933,396868100.0,1.0
796,ABBV,2023-05-01,143.8533172607422,144.78919203126722,141.14863974513747,141.16734695872066,5601000.0,2.4239501953125,0.0,2.4239501953125,38.24638427767527,137.72331652488646,155.54236931294122,34.40138378155015,-65.59861621844985,-0.09283238336965383,1.2309388925083626,-0.036844223816203336,402469100.0,1.0
797,ABBV,2023-05-02,141.8973388671875,145.07932189577477,141.50427314748234,143.70358473664828,5135600.0,-1.9559783935546875,1.9559783935546875,0.0,34.24207632237261,137.72331652488646,155.54236931294122,23.4244905829066,-76.5755094170934,-0.5385320143299737,0.8770447111406954,-0.05948751215035519,397333500.0,-1.0
798,ABBV,2023-05-03,139.67930603027344,141.79437781819354,138.93060337639315,141.38260492485898,6815300.0,-2.2180328369140625,2.2180328369140625,0.0,30.116426612849693,137.72331652488646,155.54236931294122,10.976955557919467,-89.02304444208053,-1.0585268573224766,0.4899303974480609,-0.07722277211703654,390518200.0,-1.0
799,ABBV,2023-05-04,137.91050720214844,139.44534125956457,136.96527882177244,139.44534125956457,5694300.0,-1.768798828125,1.768798828125,0.0,27.11081281408299,136.96527882177244,155.54236931294122,5.088140044456042,-94.91185995554396,-1.5949680014283274,0.07295071767278312,-0.09266661520016073,384823900.0,-1.0
800,ABBV,2023-05-05,138.5375518798828,139.80098863017827,137.70462384074722,139.0148429089436,4447700.0,0.627044677734375,0.0,0.627044677734375,29.96961559910916,136.96527882177244,155.54236931294122,8.463505406607133,-91.53649459339287,-1.947059715521874,-0.33105136896614845,-0.09781808675007819,389271600.0,1.0
801,ABBV,2023-05-08,137.99473571777344,138.69664181428328,137.33027261005446,138.64984521845275,3689500.0,-0.542816162109375,0.542816162109375,0.0,28.839780078187914,136.96527882177244,155.54236931294122,5.541539976297042,-94.45846002370295,-2.2440279065552033,-0.7136466764839595,-0.10582158735940506,385582100.0,-1.0
802,ABBV,2023-05-09,137.41448974609375,138.9399701415312,136.8904021767034,137.9572988087667,4201600.0,-0.5802459716796875,0.5802459716796875,0.0,27.558351070315936,136.8904021767034,155.54236931294122,2.8098246451021294,-97.19017535489786,-2.4974097530366066,-1.0703992917944891,-0.09252160320717218,381380500.0,-1.0
803,ABBV,2023-05-10,137.03077697753906,137.55486454425986,135.84221206566608,137.12437016316,4127300.0,-0.3837127685546875,0.3837127685546875,0.0,26.654664454338047,135.84221206566608,155.54236931294122,6.03327626756576,-93.96672373243425,-2.6980773493037304,-1.3959349032963375,-0.016457199682609724,377253200.0,-1.0
804,ABBV,2023-05-11,137.1898651123047,138.10703257517187,135.8796462800862,137.84497452841393,4300400.0,0.159088134765625,0.0,0.159088134765625,27.787473240725134,135.84221206566608,155.54236931294122,6.840823805226301,-93.15917619477369,-2.8118574399100567,-1.6791194106190814,-0.029976107799193352,381553600.0,1.0
805,ABBV,2023-05-12,137.71395874023438,138.13511378666476,136.70322661368314,137.377043271279,3526200.0,0.5240936279296875,0.0,0.5240936279296875,31.791888700072974,135.84221206566608,155.54236931294122,9.501176315875313,-90.49882368412469,-2.827149387417336,-1.9087254059787326,-0.042677907172483764,385079800.0,1.0
806,ABBV,2023-05-15,137.1898651123047,139.3517333256223,136.3195085195412,138.20061147443647,4391800.0,-0.5240936279296875,0.5240936279296875,0.0,29.880031108437876,135.84221206566608,152.7908991007565,7.951371359022932,-92.04862864097707,-2.8487200700295148,-2.0967243387888894,-0.03317520816432573,380688000.0,-1.0
807,ABBV,2023-05-16,134.1014862060547,137.5174376005841,134.0453360060886,136.50669116024832,4685400.0,-3.08837890625,3.08837890625,0.0,21.208174281884894,134.0453360060886,145.07932189577477,0.5088841016061917,-99.49111589839382,-3.0795225395828822,-2.293283978947688,-0.03993304364649286,376002600.0,-1.0
808,ABBV,2023-05-17,134.15765380859375,134.3167508056388,131.50912649946926,133.8488134212772,5482000.0,0.0561676025390625,0.0,0.0561676025390625,21.68513048168481,131.50912649946926,145.07932189577477,19.517237827286937,-80.48276217271307,-3.2207758048186292,-2.4787823441218766,-0.027212236904137987,381484600.0,1.0
809,ABBV,2023-05-18,134.2418670654297,134.3541674578991,132.87548374235595,133.46508936344924,4791200.0,0.0842132568359375,0.0,0.0842132568359375,22.49676340825289,131.50912649946926,145.07932189577477,20.13781295075837,-79.86218704924163,-3.2880224530498197,-2.6406303659074655,-0.031007367722057366,386275800.0,1.0
810,ABBV,2023-05-19,135.80477905273438,136.45053488422005,134.5787854736829,134.63493567114867,5609900.0,1.5629119873046875,0.0,1.5629119873046875,36.57313280406738,131.50912649946926,145.07932189577477,31.6550530616133,-68.3449469383867,-3.178561492385569,-2.7482165912030863,-0.015869856582920394,391885700.0,1.0
811,ABBV,2023-05-22,135.6082305908203,137.255379108366,134.56005555624677,136.14168599397468,3867300.0,-0.1965484619140625,0.1965484619140625,0.0,35.634018087813914,131.50912649946926,141.79437781819354,39.85419475252531,-60.145805247474684,-3.072257637061881,-2.8130248003748455,-0.01314460475464363,388018400.0,-1.0
812,ABBV,2023-05-23,133.380859375,135.53337393023466,133.21239451191028,135.18709059845008,5121900.0,-2.2273712158203125,2.2273712158203125,0.0,26.676986399587506,131.50912649946926,139.80098863017827,22.57313069158199,-77.426869308418,-3.1316416919926553,-2.8767481786984077,-0.026635750617814313,382896500.0,-1.0
813,ABBV,2023-05-24,132.0987091064453,133.77393282800705,131.90218341506238,133.44637096861584,4143500.0,-1.2821502685546875,1.2821502685546875,0.0,22.860382884007237,131.50912649946926,139.80098863017827,7.110376386897772,-92.88962361310223,-3.244759230048288,-2.950350388968384,-0.037110292379773924,378753000.0,-1.0
814,ABBV,2023-05-25,129.73095703125,131.20964089269847,129.39404154028304,131.05054389423017,6986600.0,-2.3677520751953125,2.3677520751953125,0.0,17.51955526369869,129.39404154028304,139.3517333256223,3.3834697661861854,-96.61653023381382,-3.485287276061314,-3.0573377663869703,-0.05796799236628192,371766400.0,-1.0
815,ABBV,2023-05-26,128.7389373779297,130.88209870311107,128.30844295963442,129.82455559154485,7590300.0,-0.9920196533203125,0.9920196533203125,0.0,15.741654949753595,128.30844295963442,139.3517333256223,3.8982441285900076,-96.10175587140999,-3.7131522727630397,-3.1885006676621845,-0.061600233570147545,364176100.0,-1.0
816,ABBV,2023-05-30,127.69075012207031,128.06509430099447,126.5770569113456,126.80167198688913,7671500.0,-1.048187255859375,1.048187255859375,0.0,14.008481967623993,126.5770569113456,139.3517333256223,8.717975897065228,-91.28202410293477,-3.9329799313555895,-3.337396520400866,-0.04780510839480112,356504600.0,-1.0
817,ABBV,2023-05-31,129.11329650878906,129.81520262410572,127.06372836721376,127.85921339638276,12579100.0,1.42254638671875,0.0,1.42254638671875,26.65416886057075,126.5770569113456,139.3517333256223,19.853650418957177,-80.14634958104281,-3.9469098104422073,-3.4592991784091343,-0.03760022001429453,369083700.0,1.0
818,ABBV,2023-06-01,124.88312530517578,126.58640987504293,122.69318188092589,126.58640987504293,11895600.0,-4.230171203613281,4.230171203613281,0.0,17.71540713339556,122.69318188092589,139.3517333256223,13.14606153794425,-86.85393846205575,-4.250294058898703,-3.617498154507048,-0.06971552143037796,357188100.0,-1.0
819,ABBV,2023-06-02,128.09317016601562,128.1867633514636,124.93927688476765,125.13581686208235,6661200.0,3.2100448608398438,0.0,3.2100448608398438,36.39290985274444,122.69318188092589,139.3517333256223,32.415713353089494,-67.58428664691051,-4.18347991640988,-3.7306945068876147,-0.056784517750470775,363849300.0,1.0
820,ABBV,2023-06-05,128.0838165283203,129.4408320350938,127.55036107596435,128.2148384197264,4276200.0,-0.0093536376953125,0.0093536376953125,0.0,36.36515728938107,122.69318188092589,137.5174376005841,36.36361075616087,-63.63638924383913,-4.084203828106183,-3.8013963711313288,-0.055486411331506225,359573100.0,-1.0
821,ABBV,2023-06-06,126.74551391601562,128.72021026235856,125.99682552031364,128.65470645387674,4359900.0,-1.3383026123046875,1.3383026123046875,0.0,32.2988926255223,122.69318188092589,137.255379108366,27.82775134684876,-72.17224865315124,-4.0666389664212375,-3.8544448901893102,-0.04974735872955438,355213200.0,-1.0
822,ABBV,2023-06-07,127.74690246582031,128.2709900372399,125.65053789982667,126.24949716435124,4645200.0,1.0013885498046875,0.0,1.0013885498046875,38.259324783267864,122.69318188092589,137.255379108366,34.70438221624622,-65.29561778375378,-3.926651011368307,-3.8688861144251097,-0.03294359702726779,359858400.0,1.0
823,ABBV,2023-06-08,128.81378173828125,129.04775039257777,127.27894793730859,128.21482255449467,4714200.0,1.0668792724609375,0.0,1.0668792724609375,44.28886938581711,122.69318188092589,137.255379108366,42.030744136757626,-57.969255863242374,-3.6871185005024074,-3.8325325916405695,-0.007069825999570956,364572600.0,1.0
824,ABBV,2023-06-09,129.3191680908203,130.26441074227054,128.28971441816506,128.7389303065907,4359500.0,0.5053863525390625,0.0,0.5053863525390625,47.11197191613669,122.69318188092589,137.255379108366,45.501280516987,-54.498719483013005,-3.4171164140032033,-3.7494493561130966,0.004507033572813235,368932100.0,1.0
825,ABBV,2023-06-12,128.8980255126953,130.71362481527393,128.1306156423062,130.62939951492305,4888500.0,-0.421142578125,0.421142578125,0.0,44.92315961189276,122.69318188092589,135.53337393023466,48.3236045686984,-51.6763954313016,-3.200230239485279,-3.639605532787533,0.009454681638809914,364043600.0,-1.0
826,ABBV,2023-06-13,129.44082641601562,129.59056979406935,128.40200493627898,128.69212380606152,4229100.0,0.5428009033203125,0.0,0.5428009033203125,48.48266722440867,122.69318188092589,133.77393282800705,60.895191736686115,-39.10480826331388,-2.950534956740711,-3.501791417578169,0.002536763571862277,368272700.0,1.0
827,ABBV,2023-06-14,127.49421691894531,130.33928423904482,127.3538414144702,129.9087755581281,6128300.0,-1.9466094970703125,1.9466094970703125,0.0,38.25279398129381,122.69318188092589,131.20964089269847,56.37360587754596,-43.62639412245404,-2.876565507556222,-3.37674623557378,0.020908282102876763,362144400.0,-1.0
828,ABBV,2023-06-15,127.17601776123047,128.0650959075651,126.7735984778544,127.98087060829782,6614900.0,-0.31819915771484375,0.31819915771484375,0.0,36.78870865936544,122.69318188092589,130.88209870311107,54.74272089514706,-45.25727910485294,-2.8112142706903285,-3.2636398425970894,-0.007160041426068853,355529500.0,-1.0
829,ABBV,2023-06-16,129.74969482421875,130.01173865229768,127.73756951283038,127.93409524373077,14615000.0,2.5736770629882812,0.0,2.5736770629882812,53.42507069093917,122.69318188092589,130.71362481527393,87.98158656640905,-12.018413433590954,-2.522668957343967,-3.1154456655464653,0.013006157538490326,370144500.0,1.0
830,ABBV,2023-06-20,128.98226928710938,130.0397980799686,127.89665111290446,128.3084383017626,4868800.0,-0.767425537109375,0.767425537109375,0.0,48.98905696756355,122.69318188092589,130.71362481527393,78.41321804373273,-21.586781956267277,-2.329071458880861,-2.9581708242133447,0.01764760978109159,365275700.0,-1.0
831,ABBV,2023-06-21,128.0838165283203,128.61725770036114,126.0436021846367,127.98086973647872,5828400.0,-0.8984527587890625,0.8984527587890625,0.0,44.048398790470955,122.69318188092589,130.71362481527393,67.21118386502941,-32.78881613497059,-2.222521827351528,-2.8110410248409816,0.0026373560219210557,359447300.0,-1.0
832,ABBV,2023-06-22,128.59854125976562,129.05711070662412,127.17600776920733,128.35520470724728,4826900.0,0.5147247314453125,0.0,0.5147247314453125,47.545409220853735,124.93927688476765,130.71362481527393,63.37104066185252,-36.62895933814748,-2.0726542249001625,-2.663363664852818,-0.001670942934917763,364274200.0,1.0
833,ABBV,2023-06-23,127.20408630371094,129.79646319660787,126.97011763093036,128.4955979471604,7394900.0,-1.3944549560546875,1.3944549560546875,0.0,39.77457989342549,125.65053789982667,130.71362481527393,30.68381858396417,-69.31618141603583,-2.042855168477928,-2.53926196557784,-0.016355516497167377,356879300.0,-1.0
834,ABBV,2023-06-26,126.29629516601562,127.4193420144838,125.11709811717135,127.4193420144838,6468100.0,-0.9077911376953125,0.9077911376953125,0.0,35.42543989434533,125.11709811717135,130.71362481527393,21.070158554663244,-78.92984144533676,-2.068644315672941,-2.4451384355968604,-0.020184408072437376,350411200.0,-1.0
835,ABBV,2023-06-27,124.09699249267578,126.23078569308358,124.0221208020965,126.23078569308358,7839900.0,-2.1993026733398438,2.1993026733398438,0.0,27.132118997971148,124.0221208020965,130.71362481527393,1.1189067574620426,-98.88109324253796,-2.240718142081647,-2.404254376893818,-0.04128399108149283,342571300.0,-1.0
836,ABBV,2023-06-28,124.01276397705078,124.6304447691886,122.56216946867333,124.0970035616631,6911900.0,-0.084228515625,0.084228515625,0.0,26.854308125970462,122.56216946867333,130.71362481527393,17.79552787444748,-82.20447212555251,-2.3567176524279887,-2.394747032000652,-0.027306751835715626,335659400.0,-1.0
837,ABBV,2023-06-29,124.68658447265625,125.3229867055984,123.65713085276248,123.88173164530627,4947600.0,0.6738204956054688,0.0,0.6738204956054688,33.17065145772034,122.56216946867333,130.71362481527393,26.061787909675083,-73.93821209032492,-2.36699121612763,-2.389195868826048,-0.01957470702729558,340607000.0,1.0
838,ABBV,2023-06-30,126.09040832519531,127.21345523376073,124.28417680830265,124.91121121324905,8710500.0,1.4038238525390625,0.0,1.4038238525390625,44.6586206678973,122.56216946867333,130.71362481527393,43.283545164647954,-56.716454835352046,-2.236080097272364,-2.358572714515311,-0.028202659774891448,349317500.0,1.0
839,ABBV,2023-07-03,126.3524398803711,126.7455055462529,124.61171234271461,125.40721156101114,2674600.0,0.26203155517578125,0.0,0.26203155517578125,46.63434682047321,122.56216946867333,130.33928423904482,48.73620260996502,-51.26379739003498,-2.0871292094683156,-2.304284013505912,-0.020389076896176972,351992100.0,1.0
840,ABBV,2023-07-05,128.7950897216797,129.0384263172352,126.00618672272381,126.5115528483174,6903300.0,2.4426498413085938,0.0,2.4426498413085938,61.44102843860548,122.56216946867333,130.33928423904482,80.14437792215625,-19.855622077843755,-1.7517895896944538,-2.1937851287436203,0.005553185504915792,358895400.0,1.0
841,ABBV,2023-07-06,128.44882202148438,129.41277196599623,127.69076568456893,128.6640692365836,6091000.0,-0.3462677001953125,0.3462677001953125,0.0,58.773693420479034,122.56216946867333,130.0397980799686,78.72352130351884,-21.276478696481163,-1.4967181988365894,-2.054371742762214,-0.0011642374541311895,352804400.0,-1.0
842,ABBV,2023-07-07,126.81102752685547,128.8231525098049,126.67065202769723,128.35521513885712,6872700.0,-1.6377944946289062,1.6377944946289062,0.0,47.515897783750795,122.56216946867333,130.0397980799686,56.820929188219715,-43.17907081178028,-1.4104695964671947,-1.9255913135032101,-0.003089985457833566,345931700.0,-1.0
843,ABBV,2023-07-10,125.86579895019531,127.36318996632359,125.46336538614607,126.72680199754,5153300.0,-0.9452285766601562,0.9452285766601562,0.0,42.14066688761319,122.56216946867333,130.0397980799686,44.18017600568869,-55.819823994311314,-1.402225026977277,-1.8209180561980236,-0.0034086210941851602,340778400.0,-1.0
844,ABBV,2023-07-11,126.87653350830078,127.05433769683216,125.10771670577472,125.40720344915921,5144800.0,1.0107345581054688,0.0,1.0107345581054688,49.227252368496835,122.56216946867333,129.79646319660787,59.63766750260554,-40.36233249739446,-1.29915743625196,-1.716565932208811,0.022398133587234526,345923200.0,1.0
845,ABBV,2023-07-12,126.32437896728516,127.84050588344599,126.14656046696929,127.11052466764562,4944100.0,-0.552154541015625,0.552154541015625,0.0,45.69913498469037,122.56216946867333,129.79646319660787,52.00520797330094,-47.99479202669906,-1.2476477780011237,-1.6227823013672735,0.018640137644719834,340979100.0,-1.0
846,ABBV,2023-07-13,126.4095230102539,126.89211970888815,125.567361161246,125.78499459944952,4631800.0,0.08514404296875,0.0,0.08514404296875,46.382861759070366,122.56216946867333,129.79646319660787,53.18215829037162,-46.81784170962838,-1.1862808824623556,-1.5354820175862902,0.013818154895208545,345610900.0,1.0
847,ABBV,2023-07-14,128.699462890625,129.27667599323456,126.91105089051175,127.4882639931213,5543400.0,2.2899398803710938,0.0,2.2899398803710938,61.447185658822974,122.56216946867333,129.41277196599623,89.58764465388296,-10.412355346117042,-0.9420092686350046,-1.4167874677960333,0.02069193525569979,351154300.0,1.0
848,ABBV,2023-07-17,127.5828628540039,128.90760680465235,127.32737136401236,128.51965535822214,4033000.0,-1.1166000366210938,1.1166000366210938,0.0,53.059692026609056,122.56216946867333,129.41277196599623,73.28834781017552,-26.71165218982448,-0.8289667334450428,-1.2992233209258353,0.009738023063090573,347121300.0,-1.0
849,ABBV,2023-07-18,129.23883056640625,130.487873095371,127.46934763427723,127.55450667153241,5392800.0,1.6559677124023438,0.0,1.6559677124023438,61.947846280274995,122.56216946867333,130.487873095371,84.24061019948627,-15.75938980051372,-0.5988537418260194,-1.1591494051058722,0.003445324240896719,352514100.0,1.0
850,ABBV,2023-07-19,130.27969360351562,130.639273225351,129.58893514350015,129.8633557302574,4784200.0,1.040863037109375,0.0,1.040863037109375,66.54246258134711,123.65713085276248,130.639273225351,94.85001017385359,-5.149989826146403,-0.3287094321348434,-0.9930614105116664,0.014253704730160965,357298300.0,1.0
851,ABBV,2023-07-20,134.5472869873047,135.04879832169237,131.1029376371142,131.37734377836017,7009800.0,4.2675933837890625,0.0,4.2675933837890625,78.70608403716321,124.28417680830265,135.04879832169237,95.34111502421266,-4.658884975787345,0.2271228688329927,-0.7490245546427345,0.0610062043603492,364308100.0,1.0
852,ABBV,2023-07-21,136.0139617919922,136.43029960720332,134.31070913475682,134.55672890355802,5654300.0,1.4666748046875,0.0,1.4666748046875,81.38916343240278,124.61171234271461,136.43029960720332,96.47726241813939,-3.5227375818606155,0.7770154210326154,-0.4438165595076645,0.08062684960044209,369962400.0,1.0
853,ABBV,2023-07-24,135.48406982421875,136.6668823395383,135.16234828532288,135.4083825292321,4468700.0,-0.5298919677734375,0.5298919677734375,0.0,77.32741614860228,125.10771670577472,136.6668823395383,89.76731926165482,-10.232680738345177,1.1567174582779387,-0.12370975595054379,0.06784183077759476,365493700.0,-1.0
854,ABBV,2023-07-25,134.0173797607422,135.24749309639287,133.7240445979754,134.7459817977346,4778200.0,-1.4666900634765625,1.4666900634765625,0.0,66.69697322852966,125.10771670577472,136.6668823395383,77.07877313344244,-22.92122686655755,1.3240219273149876,0.1658365807025626,0.06089878182143549,360715500.0,-1.0
855,ABBV,2023-07-26,134.27285766601562,134.63243725542347,132.9670425966912,133.82811904920948,5006800.0,0.2554779052734375,0.0,0.2554779052734375,67.59239510413546,125.10771670577472,136.6668823395383,79.28894913894239,-20.711050861057608,1.460392362140027,0.42474773699005564,0.062205239514461885,365722300.0,1.0
856,ABBV,2023-07-27,140.8493194580078,143.23385908221516,136.71419710502195,136.71419710502195,13664400.0,6.5764617919921875,0.0,6.5764617919921875,81.98178941186238,125.10771670577472,143.23385908221516,86.8447484595141,-13.155251540485901,2.075210682094763,0.7548403260109973,0.0944048739170602,379386700.0,1.0
857,ABBV,2023-07-28,142.74180603027344,143.6028824830474,140.57488563053147,141.86178609767924,8000300.0,1.892486572265625,0.0,1.892486572265625,84.2968890614919,125.10771670577472,143.6028824830474,95.34431611404055,-4.655683885959452,2.6842244122446175,1.1407171432577214,0.11881645259533236,387387000.0,1.0
858,ABBV,2023-07-31,141.5400848388672,142.4106331560894,139.68542837965114,142.3443887217535,9109200.0,-1.20172119140625,1.20172119140625,0.0,77.04392920115919,125.567361161246,143.6028824830474,88.56258376248485,-11.437416237515151,3.034918670885247,1.5195574487832268,0.09518233969271517,378277800.0,-1.0
859,ABBV,2023-08-01,140.55596923828125,142.76073348019156,139.89359712322067,141.93750059708978,4409600.0,-0.9841156005859375,0.9841156005859375,0.0,71.25116315984309,125.567361161246,143.6028824830474,83.10604284511012,-16.89395715488988,3.1965882139799078,1.8549636018225633,0.07887856772245527,373868200.0,-1.0
860,ABBV,2023-08-02,141.350830078125,142.47686989195233,140.149088531417,140.149088531417,5756400.0,0.79486083984375,0.0,0.79486083984375,73.13371957666622,126.91105089051175,143.6028824830474,86.50805699519822,-13.491943004801781,3.350231732529039,2.1540172279638585,0.05056618563748727,379624600.0,1.0
861,ABBV,2023-08-03,141.03855895996094,141.33189413641165,140.21531167921222,140.953399929113,4674300.0,-0.3122711181640625,0.3122711181640625,0.0,71.02543020787236,127.32737136401236,143.6028824830474,84.2442826874582,-15.755717312541808,3.4075179130483946,2.404717364980766,0.036941774960227436,374950300.0,-1.0
862,ABBV,2023-08-04,139.78948974609375,142.47685035974357,139.2501348263746,140.96284478694443,4231200.0,-1.2490692138671875,1.2490692138671875,0.0,62.68516395051828,127.46934763427723,143.6028824830474,76.36356339327371,-23.636436606726296,3.313927286274435,2.5865593492395,0.031778052781120225,370719100.0,-1.0
863,ABBV,2023-08-07,142.249755859375,142.7701962164661,139.85574465538423,140.04499175651873,3800600.0,2.46026611328125,0.0,2.46026611328125,70.54578674803147,129.58893514350015,143.6028824830474,90.34442908277602,-9.655570917223985,3.3990962881659925,2.7490667370247985,0.06142767537561067,374519700.0,1.0
864,ABBV,2023-08-08,141.57789611816406,143.59341289313667,140.91552411939716,142.67554939533588,4013400.0,-0.6718597412109375,0.6718597412109375,0.0,66.1546189661895,131.1029376371142,143.6028824830474,83.80003760142858,-16.19996239857142,3.3734923497432305,2.873951859568485,0.054404431238952666,370506300.0,-1.0
865,ABBV,2023-08-09,142.6660919189453,143.8867478552658,141.8523164818561,142.40114311976527,3737100.0,1.08819580078125,0.0,1.08819580078125,69.68151589172268,132.9670425966912,143.8867478552658,88.82153036720487,-11.178469632795132,3.401795568992924,2.9795206014533733,0.012898695342856481,374243400.0,1.0
866,ABBV,2023-08-10,143.30007934570312,144.62482335795534,142.47684659799117,143.07297418419125,3275800.0,0.6339874267578125,0.0,0.6339874267578125,71.66632085545862,132.9670425966912,144.62482335795534,88.63639624572458,-11.363603754275422,3.4357780503801507,3.0707720912387293,0.003911070841511544,377519200.0,1.0
867,ABBV,2023-08-11,144.0003204345703,145.24937738562727,143.56505351305367,143.782686973812,3454800.0,0.7002410888671875,0.0,0.7002410888671875,73.84818192362962,132.9670425966912,145.24937738562727,89.83045998565268,-10.169540014347325,3.4791080237939696,3.1524392777497776,0.017381899964973968,380974000.0,1.0
868,ABBV,2023-08-14,144.08547973632812,144.9087125485104,143.4231076783293,144.79516717817572,2570900.0,0.0851593017578125,0.0,0.0851593017578125,74.12775200624435,132.9670425966912,145.24937738562727,90.52380781585939,-9.476192184140613,3.480201388588398,3.217991699917502,0.02511106797651097,383544900.0,1.0
869,ABBV,2023-08-15,143.9435272216797,144.681600973484,142.68501314780121,143.42310133823287,3636300.0,-0.1419525146484375,0.1419525146484375,0.0,72.63430607061917,136.71419710502195,145.24937738562727,84.70037982777124,-15.299620172228757,3.430073751420167,3.2604081102180356,0.018342284527948616,379908600.0,-1.0
870,ABBV,2023-08-16,143.40419006347656,145.3440054468163,143.24332929647576,144.38828370825462,3214900.0,-0.539337158203125,0.539337158203125,0.0,66.73965887716412,139.2501348263746,145.3440054468163,68.16776226208854,-31.832237737911463,3.3086867552474644,3.270063839223922,0.01677293869818386,376693700.0,-1.0
871,ABBV,2023-08-17,141.9564208984375,143.7448327182869,141.86179012841504,143.03514525900334,5285700.0,-1.4477691650390625,1.4477691650390625,0.0,53.33353366818426,139.2501348263746,145.3440054468163,44.40996930562896,-55.59003069437104,3.060385594023586,3.228128190183855,0.015501388239413716,371408000.0,-1.0
872,ABBV,2023-08-18,142.06997680664062,142.81750796618869,141.208885826919,142.21190853357083,4050900.0,0.113555908203125,0.0,0.113555908203125,54.166750919031365,139.2501348263746,145.3440054468163,46.27341399088704,-53.72658600911295,2.840030049057816,3.150508561958648,-0.001263826792870515,375458900.0,1.0
873,ABBV,2023-08-21,142.0889129638672,142.26870278606674,140.87771403798928,141.66310332312779,3944800.0,0.0189361572265625,0.0,0.0189361572265625,54.32366956969644,139.2501348263746,145.3440054468163,46.58415503555317,-53.41584496444683,2.6365323776633147,3.047713325099582,0.0036094394655830087,379403700.0,1.0
874,ABBV,2023-08-22,140.2720947265625,141.93748940433392,140.01660320281883,141.93748940433392,3209900.0,-1.8168182373046875,1.8168182373046875,0.0,39.39296937811085,139.2501348263746,145.3440054468163,16.77029204984715,-83.22970795015286,2.302119557752576,2.898594571630181,-0.016780421753915697,376193800.0,-1.0
875,ABBV,2023-08-23,139.1744384765625,140.9912365708808,138.0957141568539,140.67897236798783,5414800.0,-1.09765625,1.09765625,0.0,33.058906860528765,138.0957141568539,145.3440054468163,14.88246369461519,-85.11753630538482,1.926317909016234,2.7041392391073917,-0.028790220410051193,370779000.0,-1.0
876,ABBV,2023-08-24,138.74864196777344,139.87468177671576,138.48369312315515,139.02304811447485,3986300.0,-0.4257965087890625,0.4257965087890625,0.0,30.839415714962968,138.0957141568539,145.3440054468163,9.008023888661008,-90.99197611133899,1.5759674039317133,2.4785048720722562,-0.03646990819845497,366792700.0,-1.0
877,ABBV,2023-08-25,138.80538940429688,139.73271019175095,138.3417217912566,139.1176535797779,3275100.0,0.0567474365234375,0.0,0.0567474365234375,31.54614791370355,138.0957141568539,145.3440054468163,9.79093167000283,-90.20906832999717,1.2880433860077574,2.2404125748593566,-0.036645540839324364,370067800.0,1.0
878,ABBV,2023-08-28,139.50563049316406,140.11124435391685,138.88111646686377,139.183908958611,2806900.0,0.7002410888671875,0.0,0.7002410888671875,40.24076575813201,138.0957141568539,145.3440054468163,19.451706338880932,-80.54829366111906,1.1036430213785877,2.0130586641632027,-0.030830818267229665,372874700.0,1.0
879,ABBV,2023-08-29,139.6570281982422,140.90608507658413,138.6256192066174,140.0355368456012,3419100.0,0.151397705078125,0.0,0.151397705078125,42.07616079662206,138.0957141568539,145.3440054468163,21.540442828924917,-78.45955717107509,0.958669982585576,1.8021809278476772,-0.026130072374982438,376293800.0,1.0
880,ABBV,2023-08-30,140.34779357910156,140.80198949307723,139.0041060009344,140.1585320462029,3486400.0,0.690765380859375,0.0,0.690765380859375,50.13830794184491,138.0957141568539,145.3440054468163,31.07048726596293,-68.92951273403708,0.8892658944535015,1.6195979211688423,-0.011331839089454232,379780200.0,1.0
881,ABBV,2023-08-31,139.06089782714844,140.71683522562262,138.97572435901228,140.4140283136458,4110700.0,-1.286895751953125,1.286895751953125,0.0,38.59183134978765,138.0957141568539,145.3440054468163,13.31601658491782,-86.68398341508218,0.722097037277365,1.440097744390547,-0.02118025952511826,375669500.0,-1.0
882,ABBV,2023-09-01,140.23423767089844,140.88715243712113,139.43939118968308,139.43939118968308,3357800.0,1.17333984375,0.0,1.17333984375,50.567965439439625,138.0957141568539,145.3440054468163,29.50382964059432,-70.49617035940568,0.6764950194780965,1.287377199408057,-0.01305292055714713,379027300.0,1.0
883,ABBV,2023-09-05,138.24713134765625,140.95340693640267,138.02002614880976,140.51812558160424,3911100.0,-1.9871063232421875,1.9871063232421875,0.0,36.61434356316072,138.02002614880976,145.3440054468163,3.100844358043194,-96.8991556419568,0.4745419937701456,1.1248101582804748,-0.014435967345134415,375116200.0,-1.0
884,ABBV,2023-09-06,137.783447265625,138.26602951233775,136.01396458905077,138.24711491032136,5304300.0,-0.46368408203125,0.46368408203125,0.0,34.08220133650153,136.01396458905077,143.7448327182869,22.888537832931192,-77.11146216706881,0.27391975917856826,0.9546320784600935,-0.009994588274712113,369811900.0,-1.0
885,ABBV,2023-09-07,140.9060821533203,140.99124118272366,138.0294742475846,138.29442307592498,5142100.0,3.1226348876953125,0.0,3.1226348876953125,57.12336693149139,136.01396458905077,142.81750796618869,71.90543652163112,-28.094563478368883,0.3627145834123837,0.8362485794505516,0.015549270644738877,374954000.0,1.0
886,ABBV,2023-09-08,141.01019287109375,141.7104086990383,140.23426086445937,140.9912638264213,4339800.0,0.1041107177734375,0.0,0.1041107177734375,57.692276898850274,136.01396458905077,142.26870278606674,79.87909525016724,-20.120904749832764,0.43645480685484017,0.7562898249314094,0.015884134443620024,379293800.0,1.0
887,ABBV,2023-09-11,141.0290985107422,141.37922084108484,140.44242811087074,140.85878043541035,2911600.0,0.0189056396484375,0.0,0.0189056396484375,57.809572206563445,136.01396458905077,141.93748940433392,84.66468999592925,-15.335310004070745,0.4907627844315243,0.7031844168314324,0.010920476916899569,382205400.0,1.0
888,ABBV,2023-09-12,141.24676513671875,141.55902942151496,139.68544371273765,141.46439863025614,2424800.0,0.2176666259765625,0.0,0.2176666259765625,59.3082748203735,136.01396458905077,141.7104086990383,91.86082486955928,-8.13917513044072,0.5450827508794021,0.6715640836410264,0.011383150271677911,384630200.0,1.0
889,ABBV,2023-09-13,143.03514099121094,144.20848164816152,141.03855308778773,141.3886609368936,5953700.0,1.7883758544921875,0.0,1.7883758544921875,69.55936585562709,136.01396458905077,144.20848164816152,85.68139344287466,-14.318606557125332,0.7240918212367546,0.682069631160172,0.01914777100214793,390583900.0,1.0
890,ABBV,2023-09-14,145.38185119628906,146.3754165961376,143.64075464031657,143.83945905710868,6336900.0,2.346710205078125,0.0,2.346710205078125,77.96437137582305,136.01396458905077,146.3754165961376,90.41094434284909,-9.589055657150903,1.0432912879191178,0.7543139625119613,0.045454570392588156,396920800.0,1.0
891,ABBV,2023-09-15,143.9435272216797,146.38485364635062,143.76373743417886,144.56805560816866,8861500.0,-1.438323974609375,1.438323974609375,0.0,65.22756275850918,136.01396458905077,146.38485364635062,76.45981543932788,-23.54018456067212,1.1667488859160358,0.8368009471927763,0.0264506700531022,388059300.0,-1.0
892,ABBV,2023-09-18,145.66571044921875,145.69409679084268,143.92461411602352,144.85193496586896,2967600.0,1.7221832275390625,0.0,1.7221832275390625,71.63058925994913,136.01396458905077,146.38485364635062,93.06575170982394,-6.934248290176058,1.387560778441923,0.9469529134426057,0.0536617217966473,391026900.0,1.0
893,ABBV,2023-09-19,145.2399139404297,146.32809563682585,143.45150206424253,145.61840815518607,3509700.0,-0.4257965087890625,0.4257965087890625,0.0,68.05552225305553,136.01396458905077,146.38485364635062,88.96006215479632,-11.03993784520368,1.5107822174298349,1.0597187742400516,0.054117289288239334,387517200.0,-1.0
894,ABBV,2023-09-20,145.35345458984375,146.55519606248598,145.12634940519874,145.7792641772534,2744800.0,0.1135406494140625,0.0,0.1135406494140625,68.53864805016357,136.01396458905077,146.55519606248598,88.599610247904,-11.400389752096007,1.5991637132576102,1.1676077620435634,0.03156267187731632,390262000.0,1.0
895,ABBV,2023-09-21,145.18313598632812,146.52682374245558,144.45453385495654,145.41969849515442,3660300.0,-0.170318603515625,0.170318603515625,0.0,66.79026643228389,136.01396458905077,146.55519606248598,86.98387299799309,-13.016127002006916,1.6365977178193418,1.2614057531987193,0.02959320195419579,386601700.0,-1.0
896,ABBV,2023-09-22,144.53021240234375,145.62785129383667,144.3220362728855,145.62785129383667,3049200.0,-0.652923583984375,0.652923583984375,0.0,60.018051050517926,136.01396458905077,146.55519606248598,80.78987578210993,-19.21012421789007,1.5951905954023573,1.328162721639447,0.024825471683312728,383552500.0,-1.0
897,ABBV,2023-09-25,146.33755493164062,146.42272840395523,143.50827670702722,144.2463505428941,3740000.0,1.807342529296875,0.0,1.807342529296875,69.79872672714066,136.01396458905077,146.55519606248598,97.93533486676746,-2.064665133232536,1.6887457799437584,1.4002793333003094,0.03604181511692883,387292500.0,1.0
898,ABBV,2023-09-26,145.63734436035156,146.29025918575292,145.0885176149219,146.10099763043755,3936300.0,-0.7002105712890625,0.7002105712890625,0.0,62.918262796797556,138.0294742475846,146.55519606248598,89.2343226525386,-10.765677347461414,1.6869417817472367,1.457611822989695,0.01819275564807188,383356200.0,-1.0
899,ABBV,2023-09-27,144.8992462158203,145.7224789766916,143.46094238050753,145.57107553326352,3621300.0,-0.73809814453125,0.73809814453125,0.0,56.1822527176008,139.68544371273765,146.55519606248598,75.89505760384027,-24.104942396159736,1.6074243610124483,1.487574330594246,-0.0033195682714010077,379734900.0,-1.0
900,ABBV,2023-09-28,144.06655883789062,145.56163553252193,143.2338542386963,145.38184572691142,3697400.0,-0.8326873779296875,0.8326873779296875,0.0,49.310310247614936,139.68544371273765,146.55519606248598,63.77398925178834,-36.22601074821166,1.4603809572285513,1.4821356559211072,0.0008547214215577359,376037500.0,-1.0
901,ABBV,2023-09-29,141.04800415039062,144.33149237389742,140.83037072181264,144.26526239068988,5581600.0,-3.0185546875,3.0185546875,0.0,32.620892671017074,139.68544371273765,146.55519606248598,19.8342002489055,-80.1657997510945,1.0877371078852889,1.4032559463139436,-0.03170070900411337,370455900.0,-1.0
902,ABBV,2023-10-02,140.2815704345703,140.85878354476367,138.83380900777274,140.48974660143546,3827800.0,-0.7664337158203125,0.7664337158203125,0.0,29.678079448098728,138.83380900777274,146.55519606248598,18.750017536212454,-81.24998246378755,0.7222438000679006,1.267053517064735,-0.03413898680698091,366628100.0,-1.0
903,ABBV,2023-10-03,139.50563049316406,140.03554262132275,137.5374432002341,139.88413915613455,4580900.0,-0.77593994140625,0.77593994140625,0.0,26.848698006763144,137.5374432002341,146.55519606248598,21.825695636090874,-78.17430436390913,0.3657596028900514,1.0867947342297983,-0.04023175171984039,362047200.0,-1.0
904,ABBV,2023-10-04,139.75164794921875,140.1206848271495,138.44581848640505,138.6918526974438,3159600.0,0.2460174560546875,0.0,0.2460174560546875,29.314025832380665,137.5374432002341,146.55519606248598,24.553841547967778,-75.44615845203222,0.10191999073637703,0.8898197855311141,-0.037411287476397104,365206800.0,1.0
905,ABBV,2023-10-05,139.52455139160156,141.49275300827222,139.18390083412726,139.97874732202453,3599500.0,-0.2270965576171875,0.2270965576171875,0.0,28.298234522383694,137.5374432002341,146.55519606248598,22.035513965851298,-77.9644860341487,-0.12406940219381113,0.687041947986129,-0.03463401130835819,361607300.0,-1.0
906,ABBV,2023-10-06,140.2720947265625,141.3035036842966,138.2660350580475,138.6161573501786,5370100.0,0.7475433349609375,0.0,0.7475433349609375,36.63762320657771,137.5374432002341,146.55519606248598,30.325199283023135,-69.67480071697686,-0.24007963600610083,0.5016176311876831,-0.041448418404363196,366977400.0,1.0
907,ABBV,2023-10-09,141.0953369140625,141.7009363315235,139.25015231700385,140.30049038588785,2903300.0,0.8232421875,0.0,0.8232421875,44.79616867160224,137.5374432002341,146.55519606248598,39.45432712756713,-60.54567287243287,-0.26256315311252365,0.34878147432764167,-0.031187107031083627,369880700.0,1.0
908,ABBV,2023-10-10,140.8871612548828,141.52114701924327,140.0828429832423,141.360286252641,3729000.0,-0.2081756591796875,0.2081756591796875,0.0,43.17415193504636,137.5374432002341,146.52682374245558,37.263057659153525,-62.73694234084648,-0.29379287689843636,0.22026660408242604,-0.027688791113251843,366151700.0,-1.0
909,ABBV,2023-10-11,141.31295776367188,142.3159803557459,140.7736028243196,141.1142533686681,3189800.0,0.4257965087890625,0.0,0.4257965087890625,47.6478724596416,137.5374432002341,146.42272840395523,42.49176562004564,-57.50823437995436,-0.28094586917032416,0.12002410943187598,-0.01911339520031996,369341500.0,1.0
910,ABBV,2023-10-12,141.7334747314453,142.0201940441943,140.5005860615697,141.5710038569559,4554400.0,0.4205169677734375,0.0,0.4205169677734375,51.957847147246724,137.5374432002341,146.42272840395523,47.22450022711628,-52.77549977288372,-0.23413337429977332,0.04919261268554611,0.004859838926354554,373895900.0,1.0
911,ABBV,2023-10-13,141.40855407714844,143.03327764756148,140.81599685356554,142.35470899226812,4304700.0,-0.324920654296875,0.324920654296875,0.0,48.40503211157456,137.5374432002341,146.29025918575292,44.22703371485176,-55.77296628514824,-0.22070832795708384,-0.004787575442979893,0.008033725592655694,369591200.0,-1.0
912,ABBV,2023-10-16,140.7108612060547,142.88035292233855,140.41458989784775,141.65703066597666,3704400.0,-0.69769287109375,0.69769287109375,0.0,41.39245695096387,137.5374432002341,145.7224789766916,38.77097293756792,-61.22902706243208,-0.2633313460042075,-0.05649632955522543,0.008639297988404016,365886800.0,-1.0
913,ABBV,2023-10-17,142.57452392578125,143.0332807377863,140.63441048069487,140.80644793098492,5372400.0,1.8636627197265625,0.0,1.8636627197265625,59.483680574956495,137.5374432002341,145.56163553252193,62.773678857109296,-37.22632114289071,-0.14505627029652146,-0.07420831770348464,0.020199232123461197,371259200.0,1.0
914,ABBV,2023-10-18,142.6700897216797,142.9854795343129,141.77170927050952,142.66053775759428,4910500.0,0.0955657958984375,0.0,0.0955657958984375,60.210400494772756,137.5374432002341,144.33149237389742,75.54620801600838,-24.45379198399162,-0.043114067487550756,-0.06798946766029787,0.022544694096521933,376169700.0,1.0
915,ABBV,2023-10-19,139.07659912109375,141.97243414853557,136.98356666730544,141.97243414853557,6147100.0,-3.5934906005859375,3.5934906005859375,0.0,33.86004263268549,136.98356666730544,143.0332807377863,34.59721285012643,-65.40278714987356,-0.24941371071827234,-0.10427431627189278,-0.008522690188659254,370022600.0,-1.0
916,ABBV,2023-10-20,139.755126953125,140.97844909719308,138.84719460007997,138.84719460007997,4223800.0,0.67852783203125,0.0,0.67852783203125,39.61743247613334,136.98356666730544,143.0332807377863,45.81307899067805,-54.18692100932194,-0.35407458749520515,-0.15423437051655528,-0.009498612712862231,374246400.0,1.0
917,ABBV,2023-10-23,138.32156372070312,139.93673533189553,137.81503251026615,139.6882530006168,3903300.0,-1.433563232421875,1.433563232421875,0.0,32.6820803760139,136.98356666730544,143.0332807377863,22.11669903419643,-77.88330096580357,-0.5463971324282113,-0.2326669228988865,-0.0182103004370866,370343100.0,-1.0
918,ABBV,2023-10-24,139.83160400390625,140.4623836653183,138.67518920780296,138.7229636141188,3362900.0,1.510040283203125,0.0,1.510040283203125,44.49223346597224,136.98356666730544,143.0332807377863,47.07722221943681,-52.92277778056318,-0.5703913871210489,-0.300211815743319,-0.01048278787174639,373706000.0,1.0
919,ABBV,2023-10-25,138.82810974121094,140.39549252966972,138.40760450106907,139.64047890740977,5461500.0,-1.0034942626953125,1.0034942626953125,0.0,39.21665961201848,136.98356666730544,143.0332807377863,30.48975624989968,-69.51024375010032,-0.6627409422421522,-0.3727176410430857,-0.02049879180440206,368244500.0,-1.0
920,ABBV,2023-10-26,138.770751953125,139.4875430423283,137.8437009777699,138.44581015930933,5569400.0,-0.0573577880859375,0.0573577880859375,0.0,38.91236202987595,136.98356666730544,143.0332807377863,29.541648828330608,-70.45835117166939,-0.732117529010651,-0.4445976186365988,-0.018653766324378984,362675100.0,-1.0
921,ABBV,2023-10-27,132.7783660888672,136.6681591570971,130.0067798832774,132.62546174922892,9427200.0,-5.9923858642578125,5.9923858642578125,0.0,20.10590890151593,130.0067798832774,143.0332807377863,21.27652112063884,-78.72347887936117,-1.2561542681688138,-0.6069089485430419,-0.05637443370893225,353247900.0,-1.0
922,ABBV,2023-10-30,135.60731506347656,139.25817797832912,134.4413337355086,134.4413337355086,9258500.0,2.828948974609375,0.0,2.828948974609375,36.75585639621398,130.0067798832774,143.0332807377863,42.993396636216644,-57.006603363783356,-1.4267380713219495,-0.7708747730988235,-0.048867137483352585,362506400.0,1.0
923,ABBV,2023-10-31,134.92874145507812,135.9226998865047,133.49515934229666,135.79845143678853,10394000.0,-0.6785736083984375,0.6785736083984375,0.0,34.75142767827373,130.0067798832774,143.0332807377863,37.78421869981355,-62.21578130018646,-1.5982584548461034,-0.9363515094482796,-0.05426048502319836,352112400.0,-1.0
924,ABBV,2023-11-01,136.16163635253906,137.34673620225269,135.473515740854,135.5786456838379,4207800.0,1.2328948974609375,0.0,1.2328948974609375,41.44565138598719,130.0067798832774,143.0332807377863,47.24873193503276,-52.75126806496725,-1.6160761600337423,-1.0722964395653722,-0.020959405011166776,356320200.0,1.0
925,ABBV,2023-11-02,136.91665649414062,137.4040837911269,134.28842237578095,135.05300249047977,4066800.0,0.7550201416015625,0.0,0.7550201416015625,45.403629337771676,130.0067798832774,143.0332807377863,53.04476380908913,-46.95523619091087,-1.5513895512634122,-1.1681150619049803,-0.020310313624032017,360387000.0,1.0
926,ABBV,2023-11-03,135.1581268310547,137.57610095297565,134.65159562500182,137.57610095297565,5414500.0,-1.7585296630859375,1.7585296630859375,0.0,38.42368039879422,130.0067798832774,143.0332807377863,39.545131922316926,-60.454868077683074,-1.6233110753361188,-1.2591542645912082,-0.022870164308119056,354972500.0,-1.0
927,ABBV,2023-11-06,134.94786071777344,136.0660530219897,134.73760084007623,135.60731082662824,4377000.0,-0.21026611328125,0.21026611328125,0.0,37.62566125018604,130.0067798832774,142.9854795343129,38.070692498857646,-61.92930750114236,-1.6779339414059677,-1.3429101999541602,-0.0349258904732036,350595500.0,-1.0
928,ABBV,2023-11-07,135.86537170410156,135.8844756341984,134.34577802169616,135.25371052848948,5024400.0,0.917510986328125,0.0,0.917510986328125,43.53062486915177,130.0067798832774,141.97243414853557,48.9617340677673,-51.0382659322327,-1.6284161202845837,-1.400011384020245,-0.021341052922439152,355619900.0,1.0
929,ABBV,2023-11-08,135.74110412597656,137.51874644586732,135.63597419263866,137.08867474881245,5299100.0,-0.124267578125,0.124267578125,0.0,42.895992153054586,130.0067798832774,140.97844909719308,52.264829816653204,-47.735170183346796,-1.5809757410765428,-1.4362042554315047,-0.021832034376896736,350320800.0,-1.0
930,ABBV,2023-11-09,131.9277801513672,135.33016070157626,129.83476246363264,134.75672200870406,14970300.0,-3.813323974609375,3.813323974609375,0.0,28.29170302397779,129.83476246363264,140.4623836653183,19.694131433688746,-80.30586856631126,-1.8299873195453529,-1.5149608682542746,-0.0064060581746480105,335350500.0,-1.0
931,ABBV,2023-11-10,132.45343017578125,133.18933976400868,130.3603978998414,132.51077112857658,4586400.0,0.5256500244140625,0.0,0.5256500244140625,31.975292953980713,129.83476246363264,140.4623836653183,24.640205578020204,-75.3597944219798,-1.962295109052917,-1.6044277164140033,-0.023257483464066864,339936900.0,1.0
932,ABBV,2023-11-13,132.50123596191406,132.99821525439734,131.3448064623797,132.4534469674756,4454700.0,0.0478057861328125,0.0,0.0478057861328125,32.34001786707779,129.83476246363264,140.39549252966972,25.248950419220545,-74.75104958077947,-2.0397791536872205,-1.6914980038686471,-0.01799101857014096,344391600.0,1.0
933,ABBV,2023-11-14,131.94691467285156,133.89659479865668,131.851351267879,132.77838775356503,4509200.0,-0.5543212890625,0.5543212890625,0.0,30.175402106749587,129.83476246363264,139.4875430423283,21.881282724695758,-78.11871727530423,-2.121460041873661,-1.77749041146965,-0.03095381190025559,339882400.0,-1.0
934,ABBV,2023-11-15,131.50726318359375,132.1284762258984,130.26482251583406,132.1284762258984,6473200.0,-0.4396514892578125,0.4396514892578125,0.0,28.433719055126588,129.83476246363264,139.25817797832912,17.74834949549583,-82.25165050450417,-2.1963507706001053,-1.8612624832957412,-0.03950865766853118,333409200.0,-1.0
935,ABBV,2023-11-16,132.15716552734375,132.67326329482583,130.98163218631626,132.15716552734375,5257000.0,0.64990234375,0.0,0.64990234375,34.84777539194516,129.83476246363264,139.25817797832912,24.64502451461636,-75.35497548538363,-2.178152142943077,-1.9246404152252083,-0.022203336004072427,338666200.0,1.0
936,ABBV,2023-11-17,132.17630004882812,132.7306203261868,131.29703792778986,132.23364101145933,4332300.0,0.019134521484375,0.0,0.019134521484375,35.045540968960395,129.83476246363264,137.57610095297565,30.247192890724556,-69.75280710927544,-2.1375453116638425,-1.9672213945129353,-0.020538011156336022,342998500.0,1.0
937,ABBV,2023-11-20,132.1858367919922,132.54901562437075,131.06764439999523,131.44037519732757,4490000.0,0.0095367431640625,0.0,0.0095367431640625,35.15872974229691,129.83476246363264,137.57610095297565,30.370385322849714,-69.62961467715029,-2.080610586145184,-1.9898992328393852,-0.02708221282552381,347488500.0,1.0
938,ABBV,2023-11-21,132.58724975585938,133.18935901353515,131.7271061733116,132.58724975585938,4690800.0,0.4014129638671875,0.0,0.4014129638671875,40.21817355055156,129.83476246363264,137.57610095297565,35.555702621916105,-64.4442973780839,-1.9802713985369564,-1.9879736659788996,-0.023234335615763158,352179300.0,1.0
939,ABBV,2023-11-22,132.3387451171875,133.6480787853247,132.20494470280232,132.9026172504428,3428500.0,-0.248504638671875,0.248504638671875,0.0,38.094885351785564,129.83476246363264,137.57610095297565,32.34560350257162,-67.65439649742838,-1.8989146113472088,-1.9701618550525617,0.003115075273371515,348750800.0,-1.0
940,ABBV,2023-11-24,132.52987670898438,133.8774473007926,132.32918339378335,133.80098784347544,1636500.0,0.191131591796875,0.0,0.191131591796875,40.86548347795839,129.83476246363264,137.51874644586732,35.074438619117615,-64.92556138088239,-1.7982865216238793,-1.9357867883668256,0.0005771578214446293,350387300.0,1.0
941,ABBV,2023-11-27,132.93130493164062,133.2084723436243,131.68886401830943,132.5585741159566,5529400.0,0.40142822265625,0.0,0.40142822265625,46.65165480839614,129.83476246363264,137.51874644586732,40.298658549616555,-59.70134145038345,-1.6669307922940106,-1.8820155891522627,0.003245773268486296,355916700.0,1.0
942,ABBV,2023-11-28,131.9660186767578,133.476060307561,131.81309974583172,132.89306964366327,5347200.0,-0.9652862548828125,0.9652862548828125,0.0,36.69067487697227,129.83476246363264,137.51874644586732,27.73634377755888,-72.26365622244111,-1.6220232891653552,-1.8300171291548815,0.0001447855294958167,350569500.0,-1.0
943,ABBV,2023-11-29,132.367431640625,132.93130384224202,131.55506250848623,131.90868939042414,3996500.0,0.4014129638671875,0.0,0.4014129638671875,42.57404802285667,129.83476246363264,135.33016070157626,46.087090822740514,-53.91290917725949,-1.5363332051045688,-1.771280344344819,0.0065408437238207995,354566000.0,1.0
944,ABBV,2023-11-30,136.08517456054688,136.38144587212355,131.8991100082008,131.8991100082008,9297400.0,3.717742919921875,0.0,3.717742919921875,71.18767405700947,130.26482251583406,136.38144587212355,95.15629303425999,-4.84370696574001,-1.1551169438654085,-1.648047664248937,0.029722255448876078,363863400.0,1.0
945,ABBV,2023-12-01,137.0600128173828,137.71946293277355,135.98004294242975,136.22852526255676,4902200.0,0.9748382568359375,0.0,0.9748382568359375,74.9621966818186,130.26482251583406,137.71946293277355,91.15383065436338,-8.846169345636627,-0.7655146338721579,-1.4715410581735813,0.03694847538288304,368765600.0,1.0
946,ABBV,2023-12-04,137.76724243164062,139.04792026943193,136.926217464569,137.0600178854544,4845300.0,0.7072296142578125,0.0,0.7072296142578125,77.43656686823874,130.26482251583406,139.04792026943193,85.41883656860485,-14.581163431395153,-0.3951296681090639,-1.256258780160678,0.04222393090744925,373610900.0,1.0
947,ABBV,2023-12-05,138.1686553955078,138.6560680793198,136.34322394759823,137.7290171171103,3961700.0,0.4014129638671875,0.0,0.4014129638671875,78.80813235014512,130.26482251583406,139.04792026943193,89.9891257208889,-10.010874279111103,-0.06841756769429708,-1.0186905376674018,0.04209609634354594,377572600.0,1.0
948,ABBV,2023-12-06,139.89849853515625,140.557948612478,138.32154952783236,138.37889047661673,4978800.0,1.7298431396484375,0.0,1.7298431396484375,83.72680074742352,130.98163218631626,140.557948612478,93.11373968888317,-6.8862603111168275,0.3263263234595115,-0.7496871654420191,0.057124264033745265,382551400.0,1.0
949,ABBV,2023-12-07,141.41810607910156,141.8099553789777,138.77075354270355,141.10271624626117,7225100.0,1.5196075439453125,0.0,1.5196075439453125,86.8261103222927,131.06764439999523,141.8099553789777,96.35228117448109,-3.6477188255189112,0.7531020385704323,-0.44912932463952876,0.06706585406122723,389776500.0,1.0
950,ABBV,2023-12-08,142.6700897216797,143.4251177958126,141.4467674937909,141.51367499184246,5694600.0,1.251983642578125,0.0,1.251983642578125,88.84564611776649,131.06764439999523,143.4251177958126,93.89010965309076,-6.109890346909237,1.1787614559305553,-0.12355116852551187,0.07326178581521625,395471100.0,1.0
951,ABBV,2023-12-11,144.54331970214844,145.94823142318276,143.9698809895479,143.9985514668627,6343500.0,1.87322998046875,0.0,1.87322998046875,91.17991404328988,131.55506250848623,145.94823142318276,90.23903818984712,-9.76096181015288,1.648253573889093,0.23080977995740923,0.0953071188439647,401814600.0,1.0
952,ABBV,2023-12-12,146.4547576904297,146.7892514421973,143.52068589025373,145.01160899291378,5882200.0,1.91143798828125,0.0,1.91143798828125,92.92349501439443,131.55506250848623,146.7892514421973,97.8043218892512,-2.195678110748801,2.1497851460113395,0.6146048531681955,0.10642592271527573,407696800.0,1.0
953,ABBV,2023-12-13,147.4678192138672,147.91700945154784,145.96732957243358,146.20625992936365,8104500.0,1.0130615234375,0.0,1.0130615234375,93.6867126146271,131.55506250848623,147.91700945154784,97.25466511263113,-2.745334887368863,2.599038036056413,1.0114914897458391,0.08364353200176078,415801300.0,1.0
954,ABBV,2023-12-14,148.0221405029297,148.28974133804775,145.99600114441205,147.52516127350253,7869600.0,0.5543212890625,0.0,0.5543212890625,94.08919756636102,131.55506250848623,148.28974133804775,98.4009204010217,-1.5990795989783066,2.965617491076131,1.4023166900118975,0.07998049511459393,423670900.0,1.0
955,ABBV,2023-12-15,147.2193145751953,148.98740495685087,146.3305006940226,147.88833120597369,15203000.0,-0.802825927734375,0.802825927734375,0.0,85.03029643684842,131.55506250848623,148.98740495685087,89.85741367293171,-10.142586327068296,3.154984312128988,1.7528502144353162,0.06860899569971979,408467900.0,-1.0
956,ABBV,2023-12-18,146.6267852783203,147.5156138232093,145.03073218318542,146.22538401335993,5379600.0,-0.592529296875,0.592529296875,0.0,78.58679845650414,131.55506250848623,148.98740495685087,86.4583908586995,-13.541609141300507,3.2201270991048148,2.046305591369216,0.06121598171887177,403088300.0,-1.0
957,ABBV,2023-12-19,146.79881286621094,147.6398377816277,145.69972450637297,146.7892463189946,5476700.0,0.172027587890625,0.0,0.172027587890625,79.1169239049263,131.8991100082008,148.98740495685087,87.19244899964215,-12.807551000357842,3.2481912885147324,2.2866827307983195,0.04932371972041327,408565000.0,1.0
958,ABBV,2023-12-20,144.973388671875,147.38181080231425,144.83002170489115,147.1715509172595,4716400.0,-1.8254241943359375,1.8254241943359375,0.0,60.7135878838898,135.98004294242975,148.98740495685087,69.14042770143884,-30.85957229856116,3.087544591911467,2.4468551030209493,0.025140222078669394,403848600.0,-1.0
959,ABBV,2023-12-21,145.83352661132812,146.13936446277506,144.59108586033994,145.3174434659507,4036100.0,0.860137939453125,0.0,0.860137939453125,65.12424222323136,136.34322394759823,148.98740495685087,75.05668146307912,-24.943318536920877,2.9951110943933656,2.5565063012954328,0.022173091050966987,407884700.0,1.0
960,ABBV,2023-12-22,148.0794677734375,148.57644695694466,146.31137744899206,146.5025188016793,3372800.0,2.245941162109375,0.0,2.245941162109375,73.93929615510598,136.34322394759823,148.98740495685087,92.81932785722566,-7.180672142774336,3.0677227648891403,2.6587495940141745,0.024464278795974792,411257500.0,1.0
961,ABBV,2023-12-26,147.7736358642578,148.40441547823792,147.30534171888098,147.42002361845883,2073400.0,-0.3058319091796875,0.3058319091796875,0.0,71.1150961434909,138.32154952783236,148.98740495685087,88.62004927152151,-11.37995072847849,3.065255599275872,2.7400507950665145,0.009005362438384568,409184100.0,-1.0
962,ABBV,2023-12-27,148.0221405029297,148.10815193211369,146.9135001384967,147.22888996198978,3747400.0,0.248504638671875,0.0,0.248504638671875,72.11373863847646,138.77075354270355,148.98740495685087,90.55204670500407,-9.447953294995921,3.0482146788828857,2.801683571829789,0.0037589305383203264,412931500.0,1.0
963,ABBV,2023-12-28,147.89788818359375,148.7389276909231,147.697180270926,148.37574888854883,2601200.0,-0.1242523193359375,0.1242523193359375,0.0,70.70348302843843,141.4467674937909,148.98740495685087,85.55139696617911,-14.44860303382089,2.9902141752788793,2.839389692519607,-0.0008394171230990954,410330300.0,-1.0
964,ABBV,2023-12-29,148.108154296875,148.33753269484646,147.57295261809358,147.69718649007012,3711400.0,0.21026611328125,0.0,0.21026611328125,71.78102393256442,143.52068589025373,148.98740495685087,83.91630063179424,-16.083699368205746,2.9274690356197652,2.857005561139639,0.006037521124483192,414041700.0,1.0
965,ABBV,2024-01-02,152.74339294433594,153.04921619267208,147.91699721692285,148.04123107570763,8059900.0,4.6352386474609375,0.0,4.6352386474609375,85.42071800465628,143.52068589025373,153.04921619267208,96.79044680942536,-3.2095531905746397,3.214710894822531,2.928546627876218,0.041715486392239765,422101600.0,1.0
966,ABBV,2024-01-03,153.35508728027344,154.58796167082878,152.76252999905563,153.47932116599918,5301400.0,0.6116943359375,0.0,0.6116943359375,86.42018294531911,144.59108586033994,154.58796167082878,87.66740315747653,-12.33259684252347,3.4519191828787257,3.03322113887672,0.044661631017668624,427403000.0,1.0
967,ABBV,2024-01-04,154.310791015625,155.10402698226054,152.37066306465198,153.21170260334753,8332200.0,0.9557037353515625,0.0,0.9557037353515625,87.91385715433034,144.59108586033994,155.10402698226054,92.45467127194735,-7.545328728052654,3.674666496479233,3.161510210397223,0.06440769874589725,435735200.0,1.0
968,ABBV,2024-01-05,154.96067810058594,155.81126962302451,153.49842542249664,154.18654604549775,5607600.0,0.6498870849609375,0.0,0.6498870849609375,88.87405637211681,144.59108586033994,155.81126962302451,92.41909454934753,-7.580905450652464,3.85914992563346,3.301038153444471,0.06258609869308907,441342800.0,1.0
969,ABBV,2024-01-08,154.2821044921875,155.56278230027547,152.70516995524463,154.99889556955276,6001600.0,-0.6785736083984375,0.6785736083984375,0.0,81.11054963231476,144.59108586033994,155.81126962302451,86.37130047795988,-13.628699522040117,3.905578080276541,3.421946138810885,0.04188721645218285,435341200.0,-1.0
970,ABBV,2024-01-09,155.12313842773438,156.23177875402797,153.71822680012036,154.28209892735285,4454000.0,0.841033935546875,0.0,0.841033935546875,83.20824956649206,144.59108586033994,156.23177875402797,90.47616549617301,-9.523834503826983,3.9645364289974907,3.5304641968482064,0.04973486996170062,439795200.0,1.0
971,ABBV,2024-01-10,157.58889770507812,157.77048710051338,154.712181602304,155.08491235703656,6609900.0,2.46575927734375,0.0,2.46575927734375,87.79378551921883,144.59108586033994,157.77048710051338,98.62217264558474,-1.377827354415257,4.162247710900317,3.656820899658629,0.06463058276041544,446405100.0,1.0
972,ABBV,2024-01-11,156.52804565429688,157.80870879703252,155.86859557214396,156.97723586726624,4591500.0,-1.06085205078125,1.06085205078125,0.0,77.31289639230472,144.59108586033994,157.80870879703252,90.31094207430837,-9.689057925691637,4.185090315623398,3.7624747828515837,0.058352134548331325,441813600.0,-1.0
973,ABBV,2024-01-12,156.69207763671875,157.56045392817202,156.47980885808468,157.02978198158686,4971100.0,0.164031982421875,0.0,0.164031982421875,77.78602824464456,146.31137744899206,157.80870879703252,90.28791006789515,-9.712089932104853,4.168378778712196,3.843655582023706,0.057957128563210114,446784700.0,1.0
974,ABBV,2024-01-16,155.80441284179688,156.5955991376613,155.36058883593293,156.28683920098715,4747700.0,-0.887664794921875,0.887664794921875,0.0,68.82390682685147,146.9135001384967,157.80870879703252,81.60387728173168,-18.39612271826832,4.036971935341114,3.882318852687188,0.02004027695375643,442037000.0,-1.0
975,ABBV,2024-01-17,156.34471130371094,157.2227307170207,155.84299854394752,156.06491052316915,4423100.0,0.5402984619140625,0.0,0.5402984619140625,71.1577466982112,146.9135001384967,157.80870879703252,86.5629237658095,-13.43707623419051,3.931113209600909,3.8920777240699325,0.019494782184653836,446460100.0,1.0
976,ABBV,2024-01-18,157.56044006347656,157.9077876049958,155.34127603279714,155.4956559895797,5074300.0,1.215728759765625,0.0,1.215728759765625,75.85122971600688,147.57295261809358,157.9077876049958,96.6390605949737,-3.360939405026296,3.900357662183467,3.89373371169264,0.021059117294800922,451534400.0,1.0
977,ABBV,2024-01-19,158.97879028320312,159.07526672382843,156.8850616015844,158.14901633690627,5863000.0,1.4183502197265625,0.0,1.4183502197265625,80.19064402659552,147.57295261809358,159.07526672382843,99.16124320951026,-0.8387567904897338,3.9449576620803555,3.903978501770183,0.02592988254742279,457397400.0,1.0
978,ABBV,2024-01-22,159.5769805908203,159.63486939472952,158.00426604636525,158.66037350979707,4864000.0,0.5981903076171875,0.0,0.5981903076171875,81.78359553501073,147.91699721692285,159.63486939472952,99.50597853406484,-0.4940214659351519,3.9826627844068696,3.9197153582975206,0.03431944434554257,462261400.0,1.0
979,ABBV,2024-01-23,161.61280822753906,161.6417526273335,158.29371297461216,158.6700048944218,5784700.0,2.03582763671875,0.0,2.03582763671875,86.15541088639667,152.37066306465198,161.6417526273335,99.68779937246066,-0.31220062753934175,4.1292195688236575,3.961616200402749,0.041835601481386764,468046100.0,1.0
980,ABBV,2024-01-24,158.44813537597656,162.04703236535508,158.29375538738742,161.87336592005684,5422200.0,-3.1646728515625,3.1646728515625,0.0,60.22907821998402,152.37066306465198,162.04703236535508,62.80736216716103,-37.19263783283896,3.9445340918879594,3.958199778699792,0.005452399778228534,462623900.0,-1.0
981,ABBV,2024-01-25,159.3261260986328,159.40331607892614,157.4639527899544,158.23583787040425,4465800.0,0.87799072265625,0.0,0.87799072265625,63.723629166225585,152.70516995524463,162.04703236535508,70.87404901427897,-29.125950985721023,3.824924683652938,3.9315447596904214,0.017875904810794596,467089700.0,1.0
982,ABBV,2024-01-26,158.6217803955078,160.03047183675466,157.75341884133812,159.46121226852154,4654300.0,-0.704345703125,0.704345703125,0.0,58.93059632614978,152.70516995524463,162.04703236535508,63.33437788443334,-36.66562211556666,3.6314376019243184,3.871523328137201,0.012315254146179289,462435400.0,-1.0
983,ABBV,2024-01-29,158.1490020751953,160.89882330603422,157.92707536455285,160.02081857984447,4704100.0,-0.4727783203125,0.4727783203125,0.0,55.68660111305498,153.71822680012036,162.04703236535508,53.198207598571614,-46.80179240142839,3.4007467447966064,3.7773680114690817,0.015048285158515418,457731300.0,-1.0
984,ABBV,2024-01-30,159.12350463867188,159.1813934447548,157.5218456321196,158.44811069689794,3819600.0,0.9745025634765625,0.0,0.9745025634765625,60.8165744618791,154.712181602304,162.04703236535508,60.14196033257656,-39.85803966742344,3.258989192340863,3.6736922476434386,0.01777350389270871,461550900.0,1.0
985,ABBV,2024-01-31,158.6217803955078,160.03047183675466,158.18759961842295,159.92433744924642,4993900.0,-0.5017242431640625,0.5017242431640625,0.0,56.903239309295266,155.34127603279714,162.04703236535508,48.92072124337554,-51.07927875662446,3.0707625185424092,3.5531063018232327,0.006736083826648809,456557000.0,-1.0
986,ABBV,2024-02-01,161.6996612548828,161.78649446491374,156.95258771423357,157.9463848223226,5584400.0,3.077880859375,0.0,3.077880859375,70.38979667948571,155.34127603279714,162.04703236535508,94.81980714411435,-5.180192855885663,3.1338259906043504,3.469250239579456,0.017114679051417836,462141400.0,1.0
987,ABBV,2024-02-02,162.74171447753906,166.7748067001424,159.422618602761,163.4653540529418,7870400.0,1.04205322265625,0.0,1.04205322265625,73.61528111265905,155.34127603279714,166.7748067001424,64.72574972731698,-35.27425027268302,3.2306483298892203,3.421529857641409,0.019832020100904124,470011800.0,1.0
988,ABBV,2024-02-05,165.24066162109375,167.0449461106179,162.52942799602695,163.8705726075273,6486700.0,2.4989471435546875,0.0,2.4989471435546875,79.72617054164476,155.34127603279714,167.0449461106179,84.58360089162638,-15.416399108373621,3.469035993716318,3.431031084856391,0.022447808644268763,476498500.0,1.0
989,ABBV,2024-02-06,167.19932556152344,167.8457898559122,163.80305450218924,165.61696764996321,7037400.0,1.9586639404296875,0.0,1.9586639404296875,83.23729898816,155.34127603279714,167.8457898559122,94.8301525070592,-5.169847492940805,3.772520477789328,3.4993289634429785,0.055230629030638134,483535900.0,1.0
990,ABBV,2024-02-07,168.85885620117188,169.38952810073215,167.2282675970437,167.89400355560153,6409100.0,1.6595306396484375,0.0,1.6595306396484375,85.66445833678652,156.8850616015844,169.38952810073215,95.75614121884813,-4.243858781151864,4.099685745934863,3.619400319941356,0.05983155641804605,489945000.0,1.0
991,ABBV,2024-02-08,168.64659118652344,169.7272361848488,168.1738228020842,168.2220683799307,5709100.0,-0.2122650146484375,0.2122650146484375,0.0,83.87214840950924,156.95258771423357,169.7272361848488,91.5407065735616,-8.459293426438403,4.292358923559107,3.753992040664906,0.06319945953210038,484235900.0,-1.0
992,ABBV,2024-02-09,167.96157836914062,169.235176418384,166.96778115596683,168.91678794793725,3502700.0,-0.6850128173828125,0.6850128173828125,0.0,77.81013632472798,156.95258771423357,169.7272361848488,86.17842346292645,-13.821576537073557,4.339753024031239,3.871144237338173,0.0620464003261918,480733200.0,-1.0
993,ABBV,2024-02-12,166.987060546875,168.6176492106778,166.17657310584744,167.44052776220425,3477100.0,-0.974517822265625,0.974517822265625,0.0,69.55768205775496,156.95258771423357,169.7272361848488,78.54989400078703,-21.45010599921297,4.249689965655961,3.9468533830017307,0.04941794064968108,477256100.0,-1.0
994,ABBV,2024-02-13,167.19932556152344,169.04219783630862,165.92572759489423,168.32821622800353,5480400.0,0.2122650146484375,0.0,0.2122650146484375,70.34806317645108,156.95258771423357,169.7272361848488,80.21150539570485,-19.788494604295153,4.147631046836409,3.9870089157686666,0.054075456375715536,482736500.0,1.0
995,ABBV,2024-02-14,168.28961181640625,168.71414937425442,166.61076276195686,166.97741151145928,4348500.0,1.0902862548828125,0.0,1.0902862548828125,74.30230348668759,156.95258771423357,169.7272361848488,88.74627061754819,-11.2537293824518,4.107378306876285,4.011082793990191,0.040754263245708744,487085000.0,1.0
996,ABBV,2024-02-15,170.38333129882812,170.52806803437858,167.7010420251087,167.9036675658859,5276200.0,2.093719482421875,0.0,2.093719482421875,80.16365231821102,156.95258771423357,170.52806803437858,98.93383709351578,-1.0661629064842293,4.196053887478172,4.048077012687787,0.04695548922918413,492361200.0,1.0
997,ABBV,2024-02-16,171.251708984375,172.63144126215732,169.88161993338372,170.67279148227337,6689400.0,0.868377685546875,0.0,0.868377685546875,82.11579306572958,156.95258771423357,172.63144126215732,91.2000435901448,-8.79995640985519,4.286983073549152,4.09585822486006,0.03637753143996081,499050600.0,1.0
998,ABBV,2024-02-20,169.5728759765625,172.39988755336188,169.35096395960022,169.65006596561133,5484100.0,-1.6788330078125,1.6788330078125,0.0,67.33390336369081,156.95258771423357,172.63144126215732,80.49241753393474,-19.50758246606526,4.1754453802630564,4.11177565594066,0.014195932950493262,493566500.0,-1.0
999,ABBV,2024-02-21,168.98431396484375,170.42194989577695,167.40195600704828,170.09388876408093,3819100.0,-0.58856201171875,0.58856201171875,0.0,62.76361257244822,156.95258771423357,172.63144126215732,76.73855881001874,-23.261441189981262,3.9935240597421,4.088125336700948,0.0007429741412106061,489747400.0,-1.0
1000,ABBV,2024-02-22,170.5377197265625,171.10697930286173,167.0546007885096,168.6369586740179,4852300.0,1.55340576171875,0.0,1.55340576171875,69.14209143880241,159.422618602761,172.63144126215732,84.14906771342396,-15.85093228657603,3.929401273263153,4.056380524013389,0.011213559234929837,494599700.0,1.0
1001,ABBV,2024-02-23,171.83062744140625,172.6218137849655,170.78858467604002,171.02979787017614,3941800.0,1.29290771484375,0.0,1.29290771484375,73.50127434181078,162.52942799602695,172.63144126215732,92.07273045823439,-7.927269541765608,3.9375210585647835,4.032608630923668,0.023035322183995843,498541500.0,1.0
1002,ABBV,2024-02-26,172.52529907226562,173.47085054193565,171.74377078552428,172.55424347381287,4327400.0,0.694671630859375,0.0,0.694671630859375,75.63511918795083,163.80305450218924,173.47085054193565,90.21957573595208,-9.780424264047927,3.9544260796125172,4.016972120661437,0.033165674677146484,502868900.0,1.0
1003,ABBV,2024-02-27,172.69898986816406,173.22000384765292,170.75962652107572,172.48672109661723,3888500.0,0.1736907958984375,0.0,0.1736907958984375,76.18830783337177,165.92572759489423,173.47085054193565,89.77007161859112,-10.229928381408882,3.9364617455806865,4.0008700456452875,0.03289286178739359,506757400.0,1.0
1004,ABBV,2024-02-28,171.7437744140625,173.567345362481,170.6727873667384,173.52875773376377,4331300.0,-0.9552154541015625,0.9552154541015625,0.0,66.59394475777695,165.92572759489423,173.567345362481,76.13632343463327,-23.863676565366728,3.801327638583757,3.9609615642329814,0.020525108830986794,502426100.0,-1.0
1005,ABBV,2024-02-29,169.86231994628906,171.76308093376417,169.2255136340166,171.61834419598384,7485700.0,-1.8814544677734375,1.8814544677734375,0.0,51.77577120222362,165.92572759489423,173.567345362481,51.51516957695217,-48.48483042304784,3.5020458292500223,3.8691784172363897,-0.003057877484654248,494940400.0,-1.0
1006,ABBV,2024-03-01,172.62181091308594,172.89196850822503,169.57287265653372,169.86233142917837,4028700.0,2.759490966796875,0.0,2.759490966796875,64.9677763304021,165.92572759489423,173.567345362481,87.62651472302483,-12.37348527697517,3.4477867585563615,3.7849000855003845,0.008000515363242089,498969100.0,1.0
1007,ABBV,2024-03-04,170.82717895507812,173.65419038990106,170.08423822996895,172.08149044977978,4723600.0,-1.7946319580078125,1.7946319580078125,0.0,53.90278554837137,165.92572759489423,173.65419038990106,63.42077965815665,-36.57922034184336,3.2228235497267406,3.672484778345656,0.0073968373260886455,494245500.0,-1.0
1008,ABBV,2024-03-05,172.86302185058594,173.27790146539857,171.54116357464724,171.54116357464724,5309800.0,2.0358428955078125,0.0,2.0358428955078125,62.30594626470145,166.61076276195686,173.65419038990106,88.76727949647372,-11.232720503526288,3.1722464113996125,3.5724371049564474,0.0229530646646241,499555300.0,1.0
1009,ABBV,2024-03-06,174.69622802734375,175.7575718895022,171.84027227141829,172.12971630429433,6047100.0,1.8332061767578125,0.0,1.8332061767578125,68.30838012138032,167.0546007885096,175.7575718895022,87.80480999141315,-12.195190008586849,3.2427081614385145,3.506491316252861,0.02438468338528832,505602400.0,1.0
1010,ABBV,2024-03-07,174.22344970703125,176.00841827224798,173.22963793495887,175.78650628551486,6125200.0,-0.4727783203125,0.4727783203125,0.0,65.21797105210041,167.0546007885096,176.00841827224798,80.0647202329227,-19.935279767077304,3.2232447872111436,3.449842010444517,0.013925470105385918,499477200.0,-1.0
1011,ABBV,2024-03-08,172.56390380859375,175.7382625761889,172.39986590091405,173.42262208549508,6195600.0,-1.6595458984375,1.6595458984375,0.0,55.11809972161928,167.0546007885096,176.00841827224798,61.530213566335966,-38.469786433664034,3.0388781427164986,3.3676492368989135,0.0002237627555825572,493281600.0,-1.0
1012,ABBV,2024-03-11,173.31649780273438,174.88919771595232,171.97535311858783,172.1393763133414,5134800.0,0.752593994140625,0.0,0.752593994140625,58.48243893204171,167.0546007885096,176.00841827224798,69.93549986469372,-30.064500135306265,2.9198362396653295,3.278086637452197,0.0035756314211317086,498416400.0,1.0
1013,ABBV,2024-03-12,174.56114196777344,176.4619028910779,173.37437731495598,173.40332171703812,5391100.0,1.2446441650390625,0.0,1.2446441650390625,63.67798123383191,167.0546007885096,176.4619028910779,79.79483487847669,-20.205165121523304,2.892583157965504,3.2009859415548587,0.016404481404481475,503807500.0,1.0
1014,ABBV,2024-03-13,173.5384063720703,176.09526012571777,173.11386883052498,176.08561689885858,5987900.0,-1.022735595703125,1.022735595703125,0.0,56.92399050096513,169.2255136340166,176.4619028910779,59.600065513960175,-40.399934486039825,2.75668137227035,3.1121250276979575,0.021641564927075363,497819600.0,-1.0
1015,ABBV,2024-03-14,174.83131408691406,175.6417868576369,172.3805945975899,173.82787371208832,6999400.0,1.29290771484375,0.0,1.29290771484375,62.69544296852675,169.2255136340166,176.4619028910779,77.46681741073144,-22.533182589268563,2.721928379279973,3.034085698014361,0.012799675557456647,504819000.0,1.0
1016,ABBV,2024-03-15,171.6280059814453,174.23310537239755,171.29994486863419,173.51910906184688,20957800.0,-3.20330810546875,3.20330810546875,0.0,45.332063978006325,169.2255136340166,176.4619028910779,33.20015358604908,-66.79984641395092,2.408146574315282,2.9088978732745456,0.004687936845095164,483861200.0,-1.0
1017,ABBV,2024-03-18,172.21656799316406,173.5577126905181,171.32890525385272,172.71828080941557,8569000.0,0.58856201171875,0.0,0.58856201171875,48.363817021210714,169.2255136340166,176.4619028910779,41.33351942377582,-58.66648057622418,2.1818136787756544,2.7634810343747676,-0.0037396885146473435,492430200.0,1.0
1018,ABBV,2024-03-19,173.34544372558594,173.6059433605743,171.92710904515715,171.92710904515715,7625600.0,1.128875732421875,0.0,1.128875732421875,54.00851133894342,169.2255136340166,176.4619028910779,56.933505719708066,-43.066494280291934,2.069676127548604,2.624720053009535,-0.007732189280849178,500055800.0,1.0
1019,ABBV,2024-03-20,170.0745849609375,172.93054063126357,169.55355627240925,172.92089740461802,7326600.0,-3.2708587646484375,3.2708587646484375,0.0,39.553101671769056,169.55355627240925,176.4619028910779,7.542017175575046,-92.45798282442496,1.6973098127116089,2.43923800494995,-0.02381346915739735,492729200.0,-1.0
1020,ABBV,2024-03-21,171.2613525390625,171.49292248484323,169.6982958918726,170.59560182711607,5743600.0,1.186767578125,0.0,1.186767578125,45.64382501953559,169.55355627240925,176.4619028910779,24.720766934858407,-75.2792330651416,1.480898178399599,2.24757003963988,-0.007548225560404687,498472800.0,1.0
1021,ABBV,2024-03-22,172.17794799804688,172.69897666017135,170.56664588088913,171.00082661767107,4084000.0,0.916595458984375,0.0,0.916595458984375,50.122593853173235,169.55355627240925,176.4619028910779,37.988709462632414,-62.01129053736758,1.367587297209127,2.071573491153729,-0.006569194618641472,502556800.0,1.0
1022,ABBV,2024-03-25,172.25515747070312,172.9016070359632,171.8692222659905,172.70863943360686,4366400.0,0.07720947265625,0.0,0.07720947265625,50.518862965302816,169.55355627240925,176.4619028910779,39.106335385564606,-60.893664614435394,1.2693850855799553,1.9111358100389744,-0.013210182238015067,506923200.0,1.0
1023,ABBV,2024-03-26,172.89195251464844,173.4515688306642,172.1104242065434,172.93054014360524,4392400.0,0.6367950439453125,0.0,0.6367950439453125,53.997021016244766,169.55355627240925,176.4619028910779,48.32409875349523,-51.67590124650477,1.2287785690275825,1.774664361836696,-0.003725134227842708,511315600.0,1.0
1024,ABBV,2024-03-27,174.0111846923828,174.23309668389274,172.52530333796557,173.48051278009095,5073500.0,1.119232177734375,0.0,1.119232177734375,59.736697980371,169.55355627240925,176.4619028910779,64.52525714224542,-35.474742857754585,1.2722446506474228,1.6741804195988415,-0.004690975405719056,516389100.0,1.0
1025,ABBV,2024-03-28,175.69969177246094,175.89265937808315,173.96295387689185,174.63834785781188,5418700.0,1.688507080078125,0.0,1.688507080078125,66.92099851280452,169.55355627240925,176.4619028910779,88.96680840308137,-11.033191596918618,1.4264964799495772,1.6246436316689887,0.023723900815207255,521807800.0,1.0
1026,ABBV,2024-04-01,174.40676879882812,175.5067002882247,172.9402032946219,175.48741383440787,3502100.0,-1.2929229736328125,1.2929229736328125,0.0,57.80764797712763,169.55355627240925,176.4619028910779,70.25143343711042,-29.74856656288957,1.4279535280309972,1.5853056109413906,0.01271771253594478,518305700.0,-1.0
1027,ABBV,2024-04-02,174.3392333984375,174.66727977679398,172.23584689680334,173.08492196782817,4523800.0,-0.067535400390625,0.067535400390625,0.0,57.33704174041758,169.55355627240925,176.09526012571777,73.15643192266879,-26.84356807733122,1.4074346758923184,1.5497314239315763,0.005733001407436822,513781900.0,-1.0
1028,ABBV,2024-04-03,171.0973358154297,175.2172610812886,170.3929974471395,174.36818597048338,5893000.0,-3.2418975830078125,3.2418975830078125,0.0,39.51803650911944,169.55355627240925,175.89265937808315,24.353280224116467,-75.64671977588353,1.116706597926708,1.4631264587306028,0.006013543144774314,507888900.0,-1.0
1029,ABBV,2024-04-04,161.99876403808594,171.4543235358012,161.5645832633023,171.40607795582878,10539000.0,-9.09857177734375,9.09857177734375,0.0,19.696005033237427,161.5645832633023,175.89265937808315,3.0302796502856375,-96.96972034971436,0.15039019451393187,1.2005792058872686,-0.05408452265296626,497349900.0,-1.0
1030,ABBV,2024-04-05,164.02496337890625,165.0284037358018,161.41020601420828,162.0952579273897,7029700.0,2.0261993408203125,0.0,2.0261993408203125,28.86446244495923,161.41020601420828,175.89265937808315,18.054657584606723,-81.94534241539327,-0.4467750196558029,0.8711083607786543,-0.04735208378272171,504379600.0,1.0
1031,ABBV,2024-04-08,163.8319854736328,165.9257139901399,162.4811829090428,163.26272593463665,4745000.0,-0.1929779052734375,0.1929779052734375,0.0,28.50679384002511,161.41020601420828,175.89265937808315,16.722163010484337,-83.27783698951566,-0.9249422993302687,0.5118982287568696,-0.04889938925923254,499634600.0,-1.0
1032,ABBV,2024-04-09,164.1600341796875,164.55562731138565,161.51633253972082,163.76444104798935,5934000.0,0.3280487060546875,0.0,0.3280487060546875,30.203206352515224,161.41020601420828,175.89265937808315,18.987308962018865,-81.01269103798113,-1.2628650028732693,0.15694558243084172,-0.05050505941981953,505568600.0,1.0
1033,ABBV,2024-04-10,163.0890655517578,163.9863863001466,161.47776316275375,162.6645279695081,3231700.0,-1.0709686279296875,1.0709686279296875,0.0,27.725067522553672,161.41020601420828,175.89265937808315,11.592369713665272,-88.40763028633472,-1.5986610286421978,-0.1941757397837663,-0.06276676502107115,502336900.0,-1.0
1034,ABBV,2024-04-11,161.63211059570312,163.41707906030243,161.35229509898028,163.25305588609484,3307000.0,-1.4569549560546875,1.4569549560546875,0.0,24.56170879780275,161.35229509898028,175.89265937808315,1.924404996682183,-98.07559500331782,-1.9597550506974528,-0.5472916019665037,-0.08006605495344843,499029900.0,-1.0
1035,ABBV,2024-04-12,158.03855895996094,160.1518408563472,155.81815149002622,160.1518408563472,7029400.0,-3.5935516357421875,3.5935516357421875,0.0,18.541135687450804,155.81815149002622,175.89265937808315,11.060831390321235,-88.93916860967876,-2.5069951693960206,-0.9392323154524073,-0.09385077168505607,492000500.0,-1.0
1036,ABBV,2024-04-15,157.44451904296875,160.39532442374605,157.27896402193255,160.22003611675896,5433700.0,-0.5940399169921875,0.5940399169921875,0.0,17.712982649062056,155.81815149002622,175.89265937808315,8.101655901164643,-91.89834409883537,-2.954562604268716,-1.3422983732156692,-0.0969071277080662,486566800.0,-1.0
1037,ABBV,2024-04-16,158.291748046875,159.4603959967625,157.8437792113973,157.94115663390394,4881300.0,0.84722900390625,0.0,0.84722900390625,23.34722159778856,155.81815149002622,175.89265937808315,12.322078183148939,-87.67792181685105,-3.2039654021705246,-1.7146317790066403,-0.0748438758997898,491448100.0,1.0
1038,ABBV,2024-04-17,159.9570770263672,160.43427548246086,158.96373211326363,159.85968473411052,4792200.0,1.6653289794921875,0.0,1.6653289794921875,33.65077295028354,155.81815149002622,175.89265937808315,20.617818177268315,-79.38218182273168,-3.230007272223304,-2.017706877649973,-0.012603102399218025,496240300.0,1.0
1039,ABBV,2024-04-18,160.3563690185547,163.06370838579318,160.1323697122165,160.64853104335998,4480100.0,0.3992919921875,0.0,0.3992919921875,36.02967237567948,155.81815149002622,175.5067002882247,23.050035708795953,-76.94996429120404,-3.181748894429518,-2.250515281005882,-0.02236607333895213,500720400.0,1.0
1040,ABBV,2024-04-19,162.0606231689453,162.2456596053391,158.98321104570888,160.7069535437209,5532400.0,1.704254150390625,0.0,1.704254150390625,45.630096927806875,155.81815149002622,175.2172610812886,32.17916600528296,-67.82083399471703,-2.9717284793811984,-2.3947579206809455,-0.010812066395744058,506252800.0,1.0
1041,ABBV,2024-04-22,163.501953125,165.15751821139355,162.55730427935606,163.29743523822012,5580700.0,1.4413299560546875,0.0,1.4413299560546875,52.575418107440086,155.81815149002622,175.2172610812886,39.60904287295055,-60.39095712704945,-2.658338830306178,-2.4474741026059923,-0.00400877751991191,511833500.0,1.0
1042,ABBV,2024-04-23,165.1088104248047,165.91711890895428,163.82331833843037,164.18364307643313,4084100.0,1.6068572998046875,0.0,1.6068572998046875,59.26849793947177,155.81815149002622,171.4543235358012,59.417732854179484,-40.58226714582051,-2.2543288211568893,-2.4088450463161717,0.01238430587736672,515917600.0,1.0
1043,ABBV,2024-04-24,163.414306640625,164.69006551336162,162.38201365535656,164.1154895853316,4074700.0,-1.6945037841796875,1.6945037841796875,0.0,50.58222343711799,155.81815149002622,165.9257139901399,75.1531850583495,-24.84681494165051,-2.047280496816029,-2.3365321364161433,0.011026249910079722,511842900.0,-1.0
1044,ABBV,2024-04-25,162.9176025390625,164.86532934972007,161.24257115307518,163.27794210381802,5503700.0,-0.4967041015625,0.4967041015625,0.0,48.19331481677929,155.81815149002622,165.9257139901399,70.23900222191476,-29.76099777808524,-1.9013554360261367,-2.2494967963381423,0.03087248840542567,506339200.0,-1.0
1045,ABBV,2024-04-26,155.44808959960938,163.0831908552378,153.52957728514417,162.722851249693,10721700.0,-7.469512939453125,7.469512939453125,0.0,26.487254353642953,153.52957728514417,165.91711890895428,15.487433848679299,-84.5125661513207,-2.3612173985428058,-2.271840916779075,-0.012680209228588812,495617500.0,-1.0
1046,ABBV,2024-04-29,157.29843139648438,157.32764611170472,154.41578899493413,155.41886717743836,6219000.0,1.850341796875,0.0,1.850341796875,34.87165176781866,153.52957728514417,165.91711890895428,30.424552552833283,-69.57544744716671,-2.5469940361080887,-2.326871540644878,-0.006275226994754468,501836500.0,1.0
1047,ABBV,2024-04-30,158.38914489746094,158.78843246318917,155.5162508010783,157.0549567768304,5484800.0,1.0907135009765625,0.0,1.0907135009765625,39.56020479690707,153.52957728514417,165.91711890895428,39.22947554804729,-60.77052445195271,-2.5765114753066314,-2.3767995275772287,-0.009802205429446542,507321300.0,1.0
1048,ABBV,2024-05-01,157.49319458007812,159.41170671978412,156.928352009304,157.85351929282263,5176400.0,-0.8959503173828125,0.8959503173828125,0.0,37.03333568976454,153.52957728514417,165.91711890895428,31.99680304052808,-68.00319695947192,-2.641747540164431,-2.4297891300946692,-0.01785507152600385,502144900.0,-1.0
1049,ABBV,2024-05-02,156.6069793701172,158.19438155239007,153.9872843061124,157.93143425950348,5904300.0,-0.8862152099609375,0.8862152099609375,0.0,34.51704396715023,153.52957728514417,165.91711890895428,24.842718421691824,-75.15728157830817,-2.733448262540918,-2.4905209565839193,-0.03365187478726894,496240600.0,-1.0
1050,ABBV,2024-05-03,159.50909423828125,159.95707798136803,156.53882248642662,156.94784336838714,5849900.0,2.9021148681640625,0.0,2.9021148681640625,47.89453671667285,153.52957728514417,165.91711890895428,48.27040856632798,-51.72959143367202,-2.5426354115288916,-2.500943847572914,-0.024420863545685845,502090500.0,1.0
1051,ABBV,2024-05-06,158.476806640625,160.32715624685147,156.7920269097796,160.11290508339388,5834600.0,-1.03228759765625,1.03228759765625,0.0,44.18944460435616,153.52957728514417,165.91711890895428,39.93713608172064,-60.06286391827936,-2.446509990047275,-2.4900570760677865,-0.04016747360190143,496255900.0,-1.0
1052,ABBV,2024-05-07,158.301513671875,159.70387947861832,157.65876020045474,159.0903407231737,5301700.0,-0.17529296875,0.17529296875,0.0,43.52964829128278,153.52957728514417,165.91711890895428,38.52206137139176,-61.47793862860824,-2.3573010790995568,-2.463505876674141,-0.031287303259156296,490954200.0,-1.0
1053,ABBV,2024-05-08,156.25640869140625,158.64237149426452,155.69156603089638,157.90224052186142,5906700.0,-2.04510498046875,2.04510498046875,0.0,36.24458276075212,153.52957728514417,165.91711890895428,22.012692179542977,-77.98730782045702,-2.423686505384751,-2.455542002416263,-0.04088688848744326,485047500.0,-1.0
1054,ABBV,2024-05-09,156.2076873779297,157.1036548054333,155.83762938132767,156.60697494845115,3570000.0,-0.0487213134765625,0.0487213134765625,0.0,36.07860521736086,153.52957728514417,165.91711890895428,21.619383200601465,-78.38061679939854,-2.451964120724483,-2.4548264260779074,0.004886504429078675,481477500.0,-1.0
1055,ABBV,2024-05-10,156.54855346679688,157.22052164154465,156.1590140211348,156.5096054662216,3509500.0,0.3408660888671875,0.0,0.3408660888671875,38.357373060428884,153.52957728514417,165.91711890895428,24.371067911085166,-75.62893208891484,-2.4189847396625055,-2.447658088794827,-0.00476723081743502,484987000.0,1.0
1056,ABBV,2024-05-13,157.06471252441406,158.3210048284552,156.5972621801092,157.06471252441406,3505900.0,0.5161590576171875,0.0,0.5161590576171875,41.97180901088867,153.52957728514417,164.86532934972007,31.185714182274243,-68.81428581772576,-2.324404334067111,-2.4230073378492842,-0.008361888524016536,488492900.0,1.0
1057,ABBV,2024-05-14,157.36660766601562,158.00936117617798,155.54548758053414,157.42503710148884,4025000.0,0.3018951416015625,0.0,0.3018951416015625,44.18065095458904,153.52957728514417,164.86532934972007,33.84892646745629,-66.15107353254372,-2.1997311350932023,-2.378352097298068,-0.0008037611682207846,492517900.0,1.0
1058,ABBV,2024-05-15,159.50909423828125,160.12263299121082,157.63927812361416,158.0677804361378,5261300.0,2.142486572265625,0.0,2.142486572265625,57.445003573533796,153.52957728514417,163.0831908552378,62.58906024684936,-37.41093975315064,-1.9060739320115943,-2.2838964642407733,0.018531197522847043,497779200.0,1.0
1059,ABBV,2024-05-16,160.05447387695312,160.61930163620008,157.94117698262147,159.1779878016134,4642000.0,0.545379638671875,0.0,0.545379638671875,60.22138820611623,153.9872843061124,160.61930163620008,91.48331900936867,-8.516680990631329,-1.6107729164608884,-2.1492717546847966,0.0034191131312999445,502421200.0,1.0
1060,ABBV,2024-05-17,162.0703582763672,162.1385358526377,160.19080889602714,161.06728008251093,5152200.0,2.0158843994140625,0.0,2.0158843994140625,68.8805459865052,153.9872843061124,162.1385358526377,99.16359376371395,-0.8364062362860444,-1.2002440443073965,-1.9594662126093165,0.02267556819144656,507573400.0,1.0
1061,ABBV,2024-05-20,160.25897216796875,162.0703588382961,160.11289858970744,161.67107124441193,3058700.0,-1.8113861083984375,1.8113861083984375,0.0,56.197195622521676,153.9872843061124,162.1385358526377,76.94140986889116,-23.058590131108854,-1.009424656887802,-1.7694579014650138,0.012365380789416403,504514700.0,-1.0
1062,ABBV,2024-05-21,158.67156982421875,161.37892397253836,158.25281566018404,161.04779909542034,3645200.0,-1.58740234375,1.58740234375,0.0,47.37613293533422,153.9872843061124,162.1385358526377,57.46707105491261,-42.53292894508739,-0.9750492593295235,-1.6105761730379156,0.015456397296204738,500869500.0,-1.0
1063,ABBV,2024-05-22,155.4383544921875,157.70745824006028,155.01958545821347,157.34713349871672,6904900.0,-3.23321533203125,3.23321533203125,0.0,34.60905467047395,155.01958545821347,162.1385358526377,5.8824547267813925,-94.11754527321861,-1.1949256067113936,-1.5274460597726114,-0.004925064179977623,493964600.0,-1.0
1064,ABBV,2024-05-23,154.12364196777344,155.85711791928168,153.63671018678846,154.87352107128433,5672900.0,-1.3147125244140625,1.3147125244140625,0.0,30.724344556756492,153.63671018678846,162.1385358526377,5.727379037433325,-94.27262096256668,-1.4584533667876656,-1.5136475211756224,-0.01548983650965352,488291700.0,-1.0
1065,ABBV,2024-05-24,152.95498657226562,154.63003284570505,152.27328514934877,154.22101199195492,3689900.0,-1.1686553955078125,1.1686553955078125,0.0,27.55235872626038,152.27328514934877,162.1385358526377,6.9101277141349335,-93.08987228586507,-1.7415265053290625,-1.5592233180063106,-0.026165813352312495,484601800.0,-1.0
1066,ABBV,2024-05-28,151.2799530029297,152.26356465143195,149.92628332803974,152.26356465143195,5533500.0,-1.6750335693359375,1.6750335693359375,0.0,23.53415324076741,149.92628332803974,162.1385358526377,11.084520829907332,-88.91547917009267,-2.077081909941512,-1.6627950363933512,-0.0386781843579157,479068300.0,-1.0
1067,ABBV,2024-05-29,150.74432373046875,152.29277797984662,149.66333465749588,150.84171602388088,4254500.0,-0.5356292724609375,0.5356292724609375,0.0,22.33244687290579,149.66333465749588,162.1385358526377,8.665103320288226,-91.33489667971178,-2.3590392554046673,-1.8020438801956145,-0.054948406231429825,474813800.0,-1.0
1068,ABBV,2024-05-30,152.22459411621094,152.34145297549756,149.56595104760078,150.60797721618636,4311100.0,1.4802703857421875,0.0,1.4802703857421875,33.20794687970124,149.56595104760078,162.1385358526377,21.146352240511735,-78.85364775948827,-2.434978122014286,-1.9286307285593487,-0.048920093085068395,479124900.0,1.0
1069,ABBV,2024-05-31,157.0257568359375,157.4152962937979,152.11747645102085,152.55571205610823,15664400.0,4.8011627197265625,0.0,4.8011627197265625,56.174290094624695,149.56595104760078,162.1385358526377,59.33390710037706,-40.66609289962294,-2.0837266111232395,-1.959649905072127,-0.031125996721914295,494789300.0,1.0
1070,ABBV,2024-06-03,156.00318908691406,158.92477944915862,154.67873419496414,155.81815265304226,4467800.0,-1.0225677490234375,1.0225677490234375,0.0,51.79737259211461,149.56595104760078,162.1385358526377,51.20059350670959,-48.799406493290405,-1.8663557422717645,-1.9409910725120547,-0.026555661898256533,490321500.0,-1.0
1071,ABBV,2024-06-04,157.9022216796875,158.55470841828398,155.59417002196798,156.00319089422354,4215500.0,1.8990325927734375,0.0,1.8990325927734375,58.69393712017249,149.56595104760078,162.1385358526377,66.30514537270801,-33.694854627291974,-1.5232921397050916,-1.8574512859506622,-0.004848683008452981,494537000.0,1.0
1072,ABBV,2024-06-05,161.11598205566406,161.64186181457887,157.92171092009053,158.64236040971537,5100500.0,3.2137603759765625,0.0,3.2137603759765625,67.71393100976732,149.56595104760078,162.1385358526377,91.86679737834051,-8.133202621659494,-0.9807823112378173,-1.6821174910080934,0.036526554736282524,499637500.0,1.0
1073,ABBV,2024-06-06,164.16416931152344,164.46606460418522,160.05446435340534,161.1646680947941,5186700.0,3.048187255859375,0.0,3.048187255859375,73.94149264973713,149.56595104760078,164.46606460418522,97.97387253784805,-2.0261274621519485,-0.3014017550055996,-1.4059743438075947,0.06514592580059486,504824200.0,1.0
1074,ABBV,2024-06-07,164.99195861816406,165.8879112888048,163.40455629801872,164.58293771591363,3781700.0,0.827789306640625,0.0,0.827789306640625,75.426717198083,149.56595104760078,165.8879112888048,94.5107532587971,-5.489246741202903,0.30034571100526364,-1.0647103328450231,0.07869617274760388,508605900.0,1.0
1075,ABBV,2024-06-10,166.00477600097656,166.28718987291236,163.30716998982874,164.58292877611825,4247500.0,1.0128173828125,0.0,1.0128173828125,77.25673235568634,149.56595104760078,166.28718987291236,98.31104695718895,-1.6889530428110446,0.849172084303575,-0.6819338494153034,0.09733492578333713,512853400.0,1.0
1076,ABBV,2024-06-11,163.31690979003906,166.1800709244655,163.04422919247256,165.80026474499942,3790200.0,-2.6878662109375,2.6878662109375,0.0,62.91046791907717,149.56595104760078,166.28718987291236,82.23648311046743,-17.763516889532575,1.0550704045702162,-0.33453299861819946,0.08340337963272249,509063200.0,-1.0
1077,ABBV,2024-06-12,161.74899291992188,164.13495563756118,160.71669993792125,163.49221699026353,4725600.0,-1.5679168701171875,1.5679168701171875,0.0,55.92104861936998,149.56595104760078,166.28718987291236,72.85968461785951,-27.140315382140496,1.0792871683644307,-0.05176896522167335,0.06256806831384853,504337600.0,-1.0
1078,ABBV,2024-06-13,162.2067108154297,162.5378208566575,160.6874860521694,161.66134960400072,3690800.0,0.4577178955078125,0.0,0.4577178955078125,57.51111861704431,149.56595104760078,166.28718987291236,75.59702902331675,-24.402970976683243,1.1224739559546322,0.18307961901358782,0.03299429395462372,508028400.0,1.0
1079,ABBV,2024-06-14,164.1836395263672,164.8166597004964,161.6613366949312,162.11905371654035,4377600.0,1.9769287109375,0.0,1.9769287109375,63.98556473529636,149.56595104760078,166.28718987291236,87.41988934838399,-12.580110651616023,1.301221747036493,0.40670804461816895,0.05243771289121235,512406000.0,1.0
1080,ABBV,2024-06-17,165.24514770507812,165.94633059757305,162.98579216479905,163.99860364285988,4076000.0,1.0615081787109375,0.0,1.0615081787109375,67.09230554607167,149.56595104760078,166.28718987291236,93.7681521164756,-6.231847883524393,1.511116289951815,0.6275896936848983,0.04650299373422451,516482000.0,1.0
1081,ABBV,2024-06-18,166.88124084472656,168.4881095880201,165.4301789593448,165.98528825683195,4250900.0,1.6360931396484375,0.0,1.6360931396484375,71.46927754282228,149.56595104760078,168.4881095880201,91.50800507319956,-8.491994926800443,1.7888574353993079,0.8598432420277802,0.035783283045568215,520732900.0,1.0
1082,ABBV,2024-06-20,167.63113403320312,168.293354100257,165.57628139223104,166.70595179249815,5847500.0,0.7498931884765625,0.0,0.7498931884765625,73.34429686195166,152.11747645102085,168.4881095880201,94.76516547866353,-5.234834521336464,2.0458955964642485,1.097053712915074,0.021118888099757482,526580400.0,1.0
1083,ABBV,2024-06-21,165.9365997314453,168.41020646160172,165.1575059662068,168.1862220193381,12308100.0,-1.6945343017578125,1.6945343017578125,0.0,62.61502186095075,154.67873419496414,168.4881095880201,81.52335073852927,-18.476649261470723,2.088787196059087,1.2954004095438767,0.005725376686189998,514272300.0,-1.0
1084,ABBV,2024-06-24,168.22518920898438,168.87767598191644,166.23849931351018,166.65726835284147,6249900.0,2.2885894775390625,0.0,2.2885894775390625,69.5553558258862,155.59417002196798,168.87767598191644,95.08799277164177,-4.912007228358232,2.281153425333855,1.4925510127018726,0.013375598350223061,520522200.0,1.0
1085,ABBV,2024-06-25,166.28720092773438,168.87768153347196,166.16059391122,167.60192266236965,5712700.0,-1.93798828125,1.93798828125,0.0,58.87584109872869,157.92171092009053,168.87768153347196,76.35553528617888,-23.64446471382112,2.251274301328806,1.6442956704272595,0.018187284718489627,514809500.0,-1.0
1086,ABBV,2024-06-26,166.67672729492188,167.84537534934657,165.70286382288614,165.83920411457206,5576100.0,0.3895263671875,0.0,0.3895263671875,60.289862409676275,160.05446435340534,168.87768153347196,75.05496925177735,-24.945030748222653,2.233282512082468,1.7620930387583016,0.030465317193286046,520385600.0,1.0
1087,ABBV,2024-06-27,164.5731964111328,167.07601785151746,163.36560033477414,166.8130705486052,5382000.0,-2.1035308837890625,2.1035308837890625,0.0,49.651974925752235,160.6874860521694,168.87768153347196,47.44343853372154,-52.55656146627846,2.02593283448374,1.8148609979033892,0.014589319910419007,515003600.0,-1.0
1088,ABBV,2024-06-28,167.0370635986328,167.32922560649197,164.63161968122304,165.5470537045258,24463400.0,2.4638671875,0.0,2.4638671875,59.346478567917224,160.6874860521694,168.87768153347196,77.52656894403681,-22.47343105596319,2.036939639533358,1.8592767262293832,0.01737946655645528,539467000.0,1.0
1089,ABBV,2024-07-01,165.9171142578125,169.33538454025668,165.10880579632214,166.79360029483954,5194500.0,-1.1199493408203125,1.1199493408203125,0.0,53.902902673194546,160.6874860521694,169.33538454025668,60.47282137789961,-39.52717862210039,1.9330095292414171,1.8740232868317903,0.004066482810942684,534272500.0,-1.0
1090,ABBV,2024-07-02,161.62237548828125,164.22258896837775,161.12569564670562,164.22258896837775,5965500.0,-4.29473876953125,4.29473876953125,0.0,38.34160277940467,160.6874860521694,169.33538454025668,10.810596787181236,-89.18940321281876,1.4869539623066146,1.7966094219267552,-0.031512621369698346,528307000.0,-1.0
1091,ABBV,2024-07-03,159.5577850341797,162.7325894105188,159.24615645550728,161.7489778097613,3527600.0,-2.0645904541015625,2.0645904541015625,0.0,33.049338113990004,159.24615645550728,169.33538454025668,3.0887256790582516,-96.91127432094174,0.9558382088275721,1.6284551793069186,-0.04816139344033987,524779400.0,-1.0
1092,ABBV,2024-07-05,162.878662109375,162.93709153881343,159.35328117347086,160.41478876820773,5978300.0,3.3208770751953125,0.0,3.3208770751953125,46.70279236162915,159.24615645550728,169.33538454025668,36.00380151340337,-63.99619848659663,0.7937424055894837,1.4615126245634318,-0.018428349303404645,530757700.0,1.0
1093,ABBV,2024-07-08,162.16773986816406,163.33637299302708,161.29125387953448,162.18720643726203,3500200.0,-0.7109222412109375,0.7109222412109375,0.0,44.46302025269325,159.24615645550728,169.33538454025668,28.957452325544807,-71.0425476744552,0.6009870259121328,1.2894075048331721,-0.036007980548592,527257500.0,-1.0
1094,ABBV,2024-07-09,163.6577606201172,164.12521092924973,160.55113374446958,162.6546824255321,4224600.0,1.490020751953125,0.0,1.490020751953125,50.2347417738403,159.24615645550728,169.33538454025668,43.72588395814312,-56.27411604185688,0.5619810530909604,1.1439222144847299,-0.015812643985509744,531482100.0,1.0
1095,ABBV,2024-07-10,163.7454071044922,164.0473024096997,161.76846540267096,163.07343891678374,3887800.0,0.087646484375,0.0,0.087646484375,50.58330924859458,159.24615645550728,169.33538454025668,44.594597437893704,-55.40540256210629,0.5320082178326118,1.0215394151543062,-0.017586859533442523,535369900.0,1.0
1096,ABBV,2024-07-11,165.46914672851562,165.89764903543536,162.9760586082306,163.14161361590826,3689500.0,1.7237396240234375,0.0,1.7237396240234375,57.36060857166427,159.24615645550728,169.33538454025668,61.67954793702053,-38.32045206297946,0.6399687503262328,0.9452252821886915,0.005444084072746325,539059400.0,1.0
1097,ABBV,2024-07-12,165.8294677734375,167.14418938044813,165.4593949056911,166.17032592635937,4133500.0,0.360321044921875,0.0,0.360321044921875,58.72590342774726,159.24615645550728,169.33538454025668,65.25089196745756,-34.74910803254243,0.7460036810734039,0.9053809619656341,-0.007229508225174541,543192900.0,1.0
1098,ABBV,2024-07-15,165.14151000976562,167.44128107126608,164.54199550264093,166.0063873305975,2395100.0,-0.687957763671875,0.687957763671875,0.0,54.85633692564248,159.24615645550728,169.33538454025668,58.43215660045985,-41.56784339954015,0.7656981934619012,0.8774444082648877,-0.004674648854136265,540797800.0,-1.0
1099,ABBV,2024-07-16,166.29139709472656,166.93023239321565,164.38474389042827,165.70172027668178,3829500.0,1.1498870849609375,0.0,1.1498870849609375,59.94632021516469,159.24615645550728,169.33538454025668,69.8293326311918,-30.170667368808186,0.8641313459174853,0.8747817957954073,0.028888460476710787,544627300.0,1.0
1100,ABBV,2024-07-17,172.25704956054688,172.7189712904187,166.59605644432546,166.59605644432546,6983200.0,5.9656524658203125,0.0,5.9656524658203125,76.08661087933393,159.24615645550728,172.7189712904187,96.57145343766722,-3.428546562332796,1.4072961908877915,0.9812846748138842,0.07959037864336627,551610500.0,1.0
1101,ABBV,2024-07-18,168.1980438232422,173.6428027156382,167.78526556755747,171.45114138313883,5957800.0,-4.0590057373046875,4.0590057373046875,0.0,57.800858277907714,159.24615645550728,173.6428027156382,62.180366218524455,-37.819633781475545,1.4930198004568922,1.083631699942486,0.03265855480993052,545652700.0,-1.0
1102,ABBV,2024-07-19,169.35775756835938,170.86145505751117,168.27666100913973,170.68454153123687,4293600.0,1.1597137451171875,0.0,1.1597137451171875,60.898803227109774,159.24615645550728,173.6428027156382,70.23580999454346,-29.764190005456552,1.6356804793541642,1.1940414558248218,0.04433691747841162,549946300.0,1.0
1103,ABBV,2024-07-22,170.62559509277344,171.7263371738706,169.0432708529532,170.34058687409154,4066900.0,1.2678375244140625,0.0,1.2678375244140625,64.21284484441367,159.24615645550728,173.6428027156382,79.04228826389654,-20.95771173610347,1.829949469277068,1.321223058515271,0.0425756435029685,554013200.0,1.0
1104,ABBV,2024-07-23,170.17347717285156,171.58872540403542,169.8000197204168,170.34056800267237,2933800.0,-0.452117919921875,0.452117919921875,0.0,62.048939318831856,159.24615645550728,173.6428027156382,75.90184908276628,-24.098150917233728,1.9252340065815474,1.4420252481285265,0.039256490805005484,551079400.0,-1.0
1105,ABBV,2024-07-24,173.18089294433594,173.56418810337158,169.97692392607834,170.22262633562644,6117700.0,3.007415771484375,0.0,3.007415771484375,69.84771277890536,159.35328117347086,173.6428027156382,96.76749308967975,-3.2325069103202493,2.21785495625096,1.5971911897530136,0.04660534225436552,557197100.0,1.0
1106,ABBV,2024-07-25,179.03843688964844,182.91070941279227,168.84670534770325,173.95731266395742,9442200.0,5.8575439453125,0.0,5.8575439453125,79.37345559874261,160.55113374446958,182.91070941279227,82.68181569907979,-17.318184300920205,2.889110146572449,1.8555749811169007,0.07965393179852409,566639300.0,1.0
1107,ABBV,2024-07-26,181.97703552246094,183.637986204197,178.97946313795075,180.29642444901918,6948800.0,2.9385986328125,0.0,2.9385986328125,82.56234399448874,160.55113374446958,183.637986204197,92.80564258539175,-7.1943574146082545,3.616516125121933,2.2077632099179074,0.10194605530553602,573588100.0,1.0
1108,ABBV,2024-07-29,178.81239318847656,182.93036809206984,177.42662795904337,180.87628449099745,5458500.0,-3.164642333984375,3.164642333984375,0.0,69.25744510303332,161.76846540267096,183.637986204197,77.93461932927349,-22.065380670726515,3.892757134378485,2.544761994810023,0.07529551325266404,568129600.0,-1.0
1109,ABBV,2024-07-30,183.56918334960938,184.4832041129324,179.4610462529431,180.43401819874038,6032200.0,4.7567901611328125,0.0,4.7567901611328125,75.97281238805219,162.9760586082306,184.4832041129324,95.75015306832225,-4.249846931677743,4.444282415061565,2.924666078860332,0.06567007746807119,574161800.0,1.0
1110,ABBV,2024-07-31,182.13429260253906,184.27681045376863,180.2964283486702,183.18589113602292,6473900.0,-1.4348907470703125,1.4348907470703125,0.0,70.60476233012955,164.38474389042827,184.4832041129324,88.3129777884015,-11.687022211598507,4.7112778042628065,3.281988423940827,0.08285618823214347,567687900.0,-1.0
1111,ABBV,2024-08-01,186.44883728027344,187.68717212010833,183.55937432417258,184.5421840373233,6595500.0,4.314544677734375,0.0,4.314544677734375,76.39210995318707,164.38474389042827,187.68717212010833,94.68581202083637,-5.314187979163636,5.210952652666947,3.6677812696860514,0.1009170170726632,574283400.0,1.0
1112,ABBV,2024-08-02,186.03604125976562,190.5766322651576,183.2547030094823,187.69699204992867,6303900.0,-0.4127960205078125,0.4127960205078125,0.0,74.76707970351636,164.38474389042827,190.5766322651576,82.66413272525679,-17.335867274743215,5.510122123112126,4.036249440371266,0.09031731821133371,567979500.0,-1.0
1113,ABBV,2024-08-05,181.19078063964844,186.0360248277329,179.89346475370013,184.22765874109393,6459300.0,-4.8452606201171875,4.8452606201171875,0.0,58.04449129504914,166.59605644432546,190.5766322651576,60.86060778675887,-39.13939221324113,5.295204227148247,4.288040397726663,0.06474160162812082,561520200.0,-1.0
1114,ABBV,2024-08-06,182.517578125,184.59130698893247,179.93278406806232,182.242377639163,4273200.0,1.3267974853515625,0.0,1.3267974853515625,60.813742032943736,167.78526556755747,190.5766322651576,64.63988207865482,-35.36011792134518,5.172318447351074,4.464896007651546,0.05391290587504405,565793400.0,1.0
1115,ABBV,2024-08-07,184.28662109375,186.33086684354072,182.78292361855273,184.6699162345555,6351000.0,1.76904296875,0.0,1.76904296875,64.42606705734894,168.27666100913973,190.5766322651576,71.79363552000015,-28.20636447999984,5.158216851600002,4.6035601764412375,0.02931317037433878,572144400.0,1.0
1116,ABBV,2024-08-08,187.126953125,187.43163671641904,183.70677970978213,183.70677970978213,5744600.0,2.84033203125,0.0,2.84033203125,69.6151310917468,168.84670534770325,190.5766322651576,84.12475498301525,-15.87524501698475,5.314964688172836,4.745841078787557,0.02829982139094378,577889000.0,1.0
1117,ABBV,2024-08-09,186.66502380371094,187.7264599921807,184.86649539721776,187.50041797874727,3206500.0,-0.4619293212890625,0.4619293212890625,0.0,67.7603730539789,168.84670534770325,190.5766322651576,81.99898013322493,-18.001019866775074,5.340354361417127,4.864743735313471,0.043915471826146524,574682500.0,-1.0
1118,ABBV,2024-08-12,186.91073608398438,187.29404625240608,184.4733722982485,186.81246411474856,4808300.0,0.2457122802734375,0.0,0.2457122802734375,68.27908771641154,168.84670534770325,190.5766322651576,83.1297353410396,-16.870264658960398,5.318988796015844,4.955592747453946,0.01820323364412957,579490800.0,1.0
1119,ABBV,2024-08-13,187.94268798828125,188.64048944869674,186.1244991064125,187.28420731248696,3477300.0,1.031951904296875,0.0,1.031951904296875,70.57343221427611,168.84670534770325,190.5766322651576,87.87872464144985,-12.121275358550145,5.323955085619559,5.029265215087069,0.031890729102934445,582968100.0,1.0
1120,ABBV,2024-08-14,189.6822509765625,190.02624033184944,187.19574391218433,187.71663179545823,4153400.0,1.73956298828125,0.0,1.73956298828125,74.20267661751595,177.42662795904337,190.5766322651576,93.19862360669154,-6.80137639330846,5.405942757899965,5.104600723649648,0.01734209632762962,587121500.0,1.0
1121,ABBV,2024-08-15,190.07537841796875,191.6380571432308,188.0016494772668,191.14665232312595,4719900.0,0.39312744140625,0.0,0.39312744140625,75.00647158768184,177.42662795904337,191.6380571432308,89.00407056173634,-10.995929438263664,5.4399325220164485,5.171667083323008,0.02171265917534182,591841400.0,1.0
1122,ABBV,2024-08-16,190.56678771972656,190.91077710048373,188.96481816612018,190.54714232392956,3674900.0,0.4914093017578125,0.0,0.4914093017578125,76.08136392568606,179.4610462529431,191.6380571432308,91.20252553638853,-8.797474463611463,5.443769888093897,5.226087644277186,0.051746601272860016,595516300.0,1.0
1123,ABBV,2024-08-19,193.48573303222656,193.79040162749428,190.0262538252998,190.07538231112855,4309300.0,2.9189453125,0.0,2.9189453125,81.52658072276887,179.89346475370013,193.79040162749428,97.80765647829749,-2.1923435217025133,5.617589446125038,5.304388004646757,0.06009369080996052,599825600.0,1.0
1124,ABBV,2024-08-20,192.77810668945312,194.08524532245016,190.79284199556452,193.7314332488834,3631800.0,-0.7076263427734375,0.7076263427734375,0.0,76.64576017000044,179.89346475370013,194.08524532245016,90.78946699700722,-9.210533002992777,5.633305922126169,5.37017158814264,0.04607760208150613,596193800.0,-1.0
1125,ABBV,2024-08-21,193.15158081054688,193.94765423377405,192.30636390514212,193.06313154051836,4250400.0,0.37347412109375,0.0,0.37347412109375,77.46726833846957,179.89346475370013,194.08524532245016,93.42108971189144,-6.578910288108563,5.611214989369557,5.418380268388025,0.032195403093655095,600444200.0,1.0
1126,ABBV,2024-08-22,192.99432373046875,194.1442092068458,191.99186869761795,193.62332129865325,3676700.0,-0.157257080078125,0.157257080078125,0.0,76.16559328997013,179.89346475370013,194.1442092068458,91.93104977667866,-8.06895022332134,5.517417084219346,5.43818763155429,0.03390726231290886,596767500.0,-1.0
1127,ABBV,2024-08-23,194.154052734375,194.57665369291385,192.85673677549352,193.8592068349487,4720300.0,1.15972900390625,0.0,1.15972900390625,79.14715541153535,179.93278406806232,194.57665369291385,97.11414421621406,-2.8858557837859444,5.473566143638692,5.4452633339711705,0.03875281218268811,601487800.0,1.0
1128,ABBV,2024-08-26,194.0459442138672,194.56683214077742,192.69949976088998,194.16387657573804,4182300.0,-0.1081085205078125,0.1081085205078125,0.0,78.09635175580472,182.78292361855273,194.57665369291385,95.50007100636978,-4.499928993630224,5.368209129939402,5.429852493164817,0.03247402860369064,597305500.0,-1.0
1129,ABBV,2024-08-27,192.5520782470703,194.89117017595316,191.82479365665236,194.5865015626589,2504500.0,-1.493865966796875,1.493865966796875,0.0,64.45279412246565,183.70677970978213,194.89117017595316,79.08610276118483,-20.913897238815167,5.105319493593612,5.364945893250576,0.015129656337020236,594801000.0,-1.0
1130,ABBV,2024-08-28,192.04100036621094,192.85673417849534,190.69455593929408,192.1589477222844,3910200.0,-0.511077880859375,0.511077880859375,0.0,60.29465463392502,184.4733722982485,194.89117017595316,72.64134087452462,-27.358659125475388,4.8004018051789785,5.252037075636257,0.010341275995883414,590890800.0,-1.0
1131,ABBV,2024-08-29,191.8247833251953,193.06313310154837,190.517659666911,192.6306944492654,4538300.0,-0.216217041015625,0.216217041015625,0.0,58.45379465845529,184.4733722982485,194.89117017595316,70.56588266777291,-29.43411733222708,4.4895526636314855,5.099540193235303,0.006601337098250948,586352500.0,-1.0
1132,ABBV,2024-08-30,192.93536376953125,193.12210000612495,190.832151677212,191.893587919572,3820800.0,1.1105804443359375,0.0,1.1105804443359375,64.81956737169125,186.1244991064125,194.89117017595316,77.69043242403313,-22.309567575966856,4.283440207395898,4.936320196067422,-0.0028444953230926107,590173300.0,1.0
1133,ABBV,2024-09-03,194.29164123535156,196.5127856356415,192.7289774980261,192.7682832853961,4872400.0,1.3562774658203125,0.0,1.3562774658203125,71.0665040921129,187.19574391218433,196.5127856356415,76.16041157465412,-23.839588425345877,4.1813350300415095,4.78532316286224,0.007851174450720144,595045700.0,1.0
1134,ABBV,2024-09-04,193.62332153320312,196.44399539405163,193.0631278372826,195.2646118303527,4214300.0,-0.6683197021484375,0.6683197021484375,0.0,64.54957571747629,188.0016494772668,196.5127856356415,66.0507827783341,-33.949217221665904,4.000374301970879,4.628333390683968,0.0024423342572534867,590831400.0,-1.0
1135,ABBV,2024-09-05,189.54466247558594,193.74126372017537,188.85669874610028,193.5741878856206,5902800.0,-4.0786590576171875,4.0786590576171875,0.0,39.22217170668689,188.85669874610028,196.5127856356415,8.985840147993459,-91.01415985200654,3.4876445269264877,4.400195617932472,-0.017874418211908272,584928600.0,-1.0
1136,ABBV,2024-09-06,190.07537841796875,191.39235473317837,189.51518472122137,190.14418229109623,4312600.0,0.5307159423828125,0.0,0.5307159423828125,42.60341173223313,188.85669874610028,196.5127856356415,15.917787891530816,-84.0822121084692,3.0885242424301964,4.137861342832017,-0.021007412716675833,589241200.0,1.0
1137,ABBV,2024-09-09,193.04345703125,193.23019325197785,190.6060934576332,191.6183861312255,3606900.0,2.96807861328125,0.0,2.96807861328125,57.76550854192428,188.85669874610028,196.5127856356415,54.68535487585881,-45.31464512414119,2.9773961112782956,3.9057682965212726,-0.005166236205959018,592848100.0,1.0
1138,ABBV,2024-09-10,195.92311096191406,196.0410433217827,189.59381437655327,192.74862497492114,6333300.0,2.8796539306640625,0.0,2.8796539306640625,67.40470631854404,188.85669874610028,196.5127856356415,92.29796262457546,-7.702037375424547,3.0861154547162073,3.74183772816026,0.017507121946086057,599181400.0,1.0
1139,ABBV,2024-09-11,191.24493408203125,194.28181242662754,190.0950485436837,194.28181242662754,4909300.0,-4.6781768798828125,4.6781768798828125,0.0,47.2082306076283,188.85669874610028,196.5127856356415,31.193942419768966,-68.80605758023103,2.762937121353957,3.5460576067989997,-0.004145293362675884,594272100.0,-1.0
1140,ABBV,2024-09-12,190.6847381591797,191.71669132164644,187.98201154135444,191.43166811664383,4165200.0,-0.5601959228515625,0.5601959228515625,0.0,45.331521843662934,187.98201154135444,196.5127856356415,31.68207935121884,-68.31792064878115,2.4335602666534157,3.3235581387698825,-0.005943158888301436,590106900.0,-1.0
1141,ABBV,2024-09-13,190.8714599609375,191.24491741318,188.5127079113504,190.52747060063797,2718100.0,0.1867218017578125,0.0,0.1867218017578125,46.154767425472265,187.98201154135444,196.5127856356415,33.870881911151315,-66.12911808884868,2.162663783291464,3.091379267674199,-0.01069738470060455,592825000.0,1.0
1142,ABBV,2024-09-16,192.36532592773438,192.78794186954576,191.11716848701332,192.45379019233624,3235700.0,1.493865966796875,0.0,1.493865966796875,52.72643105254051,187.98201154135444,196.5127856356415,51.38237559608309,-48.61762440391691,2.0449460027006126,2.882092614679482,-0.009914555743979592,596060700.0,1.0
1143,ABBV,2024-09-17,190.12452697753906,192.70932119920622,188.52255741881808,191.45132602585525,3534100.0,-2.2407989501953125,2.2407989501953125,0.0,43.53110862415482,187.98201154135444,196.5127856356415,25.11513506868544,-74.88486493131457,1.750659551763988,2.6558060020963836,-0.01807010915812679,592526600.0,-1.0
1144,ABBV,2024-09-18,189.623291015625,192.21790781986397,188.48322825406183,189.81002724338782,3236800.0,-0.5012359619140625,0.5012359619140625,0.0,41.65609520394003,187.98201154135444,196.5127856356415,19.239513977631898,-80.7604860223681,1.4601580727092482,2.416676416218957,0.00041482856342200947,589289800.0,-1.0
1145,ABBV,2024-09-19,190.29161071777344,190.82233635771755,188.6601580010772,190.10487447395926,3929300.0,0.6683197021484375,0.0,0.6683197021484375,45.28206592754042,187.98201154135444,196.5127856356415,27.07373505489617,-72.92626494510384,1.2692304733623985,2.1871872276476454,0.0011376134121336978,593219100.0,1.0
1146,ABBV,2024-09-20,190.14419555664062,190.4881849533067,188.82723414603723,189.68227379379695,11661200.0,-0.1474151611328125,0.1474151611328125,0.0,44.576974900159684,187.98201154135444,196.5127856356415,25.345695377564493,-74.6543046224355,1.09341954394489,1.9684336909070943,-0.01501869847958659,581557900.0,-1.0
1147,ABBV,2024-09-23,190.4980010986328,190.95992284558665,188.89601652955955,190.3702310420116,3178000.0,0.3538055419921875,0.0,0.3538055419921875,46.868079191409116,187.98201154135444,196.44399539405163,29.732856988097687,-70.2671430119023,0.9714391206120752,1.7690347768480903,-0.027689994491440273,584735900.0,1.0
1148,ABBV,2024-09-24,190.18348693847656,191.85427531400802,188.29649424016085,189.6331159426951,4286500.0,-0.31451416015625,0.31451416015625,0.0,44.961651382332725,187.98201154135444,196.0410433217827,27.316872015178202,-72.6831279848218,0.8397104329102376,1.5831699080605197,-0.0055501974399980725,580449400.0,-1.0
1149,ABBV,2024-09-25,187.97216796875,191.22528050225245,187.67733707139536,190.66507180430838,5589300.0,-2.2113189697265625,2.2113189697265625,0.0,33.805977641775186,187.67733707139536,196.0410433217827,3.5251225775772435,-96.47487742242275,0.5505333331894633,1.3766425930863087,-0.014225418439966053,574860100.0,-1.0
1150,ABBV,2024-09-26,188.60116577148438,189.55449233137503,186.36036096997452,186.83212039928142,6215700.0,0.628997802734375,0.0,0.628997802734375,38.790441390463144,186.36036096997452,196.0410433217827,23.14717826777275,-76.85282173222726,0.3678726571797597,1.174888605904999,-0.011894361733900682,581075800.0,1.0
1151,ABBV,2024-09-27,191.4414825439453,192.75845885451793,186.99919378330756,189.28914203651166,4891900.0,2.8403167724609375,0.0,2.8403167724609375,56.03842896045055,186.36036096997452,196.0410433217827,52.48722547973832,-47.51277452026167,0.4471481360900498,1.0293405119420092,-0.004802546297434707,585967700.0,1.0
1152,ABBV,2024-09-30,194.08523559570312,194.22282833983434,191.0286971400529,191.50045654548936,4550200.0,2.6437530517578125,0.0,2.6437530517578125,66.25184877647743,186.36036096997452,194.28181242662754,97.51842409184601,-2.481575908153983,0.7150605281276512,0.9664845151791376,0.020832181313629183,590517900.0,1.0
1153,ABBV,2024-10-01,193.57420349121094,195.5496455729515,193.04347785961835,194.25232958149027,3924600.0,-0.5110321044921875,0.5110321044921875,0.0,62.98799303278067,186.36036096997452,195.5496455729515,78.50276526313486,-21.497234736865135,0.8760484676491558,0.9483973056731413,0.02083558646421957,586593300.0,-1.0
1154,ABBV,2024-10-02,193.4365997314453,193.61349826759024,191.1073306968092,192.29653695467266,2946900.0,-0.137603759765625,0.137603759765625,0.0,62.0384300519355,186.36036096997452,195.5496455729515,77.00532813161925,-22.994671868380752,0.9812182232741407,0.9549614891933412,0.01652720790900397,583646400.0,-1.0
1155,ABBV,2024-10-03,192.0901336669922,193.66263502842074,191.3923472477655,193.48572150192993,3453800.0,-1.346466064453125,1.346466064453125,0.0,53.01489111497349,186.36036096997452,195.5496455729515,62.35276133640952,-37.64723866359048,0.9450238076020412,0.9529739528750812,0.010234012690499839,580192600.0,-1.0
1156,ABBV,2024-10-04,190.9500732421875,192.2768722192407,189.7313989189824,191.74616162631017,4749700.0,-1.1400604248046875,1.1400604248046875,0.0,46.41875045895871,186.36036096997452,195.5496455729515,49.94635023847323,-50.05364976152678,0.8149518661924162,0.9253695355385483,0.002373107019220777,575442900.0,-1.0
1157,ABBV,2024-10-07,190.2817840576172,191.73633819503775,189.52501639977947,191.07785750447246,5033800.0,-0.6682891845703125,0.6682891845703125,0.0,42.81562953673568,186.36036096997452,195.5496455729515,42.67386697733001,-57.32613302266999,0.6504456310916567,0.8703847546491701,0.0005168541218956157,570409100.0,-1.0
1158,ABBV,2024-10-08,189.69207763671875,191.64787416151168,188.94514773102884,190.9992162190395,4419000.0,-0.5897064208984375,0.5897064208984375,0.0,39.679654449081994,186.36036096997452,195.5496455729515,36.256540206240615,-63.743459793759385,0.4671043861850137,0.7897286809563389,0.009149810243475498,565990100.0,-1.0
1159,ABBV,2024-10-09,191.4021759033203,191.53976865199218,188.65030593339793,189.53484360041844,4478900.0,1.7100982666015625,0.0,1.7100982666015625,51.552937834954704,186.36036096997452,195.5496455729515,54.866239878047004,-45.133760121952996,0.45455592912168186,0.7226941305894076,0.014851499567238857,570469000.0,1.0
1160,ABBV,2024-10-10,191.00906372070312,191.47098546135012,189.9574501845324,191.19578495934982,3562500.0,-0.3931121826171875,0.3931121826171875,0.0,48.994932089492075,186.36036096997452,195.5496455729515,50.588298780327236,-49.41170121967277,0.4081850159530518,0.6597923076621365,-0.0022587519564518654,566906500.0,-1.0
1161,ABBV,2024-10-11,190.851806640625,191.88375976327154,190.2522921595816,191.6478800506285,2973000.0,-0.157257080078125,0.157257080078125,0.0,47.89793247489523,186.36036096997452,195.5496455729515,48.87698950139621,-51.12301049860379,0.35465812299759136,0.5987654707292275,-0.016659839915971975,563933500.0,-1.0
1162,ABBV,2024-10-14,192.2866973876953,192.96483842928234,190.3309158291015,190.90094721193574,3623900.0,1.4348907470703125,0.0,1.4348907470703125,57.836957635667474,186.36036096997452,195.5496455729515,64.49181491017136,-35.50818508982864,0.4231436297303901,0.56364110252946,-0.006651227696122697,567557400.0,1.0
1163,ABBV,2024-10-15,190.067626953125,194.4166145673319,189.43360649625566,192.9108103136772,6553500.0,-2.2190704345703125,2.2190704345703125,0.0,43.14904250288917,186.36036096997452,195.5496455729515,40.34335797967845,-59.65664202032155,0.29495835242164503,0.509904552507897,-0.017416418521611576,561003900.0,-1.0
1164,ABBV,2024-10-16,188.6807098388672,189.25527811721705,186.96686079222815,188.67079358549708,5576000.0,-1.3869171142578125,1.3869171142578125,0.0,36.469953237082244,186.96686079222815,195.5496455729515,19.96844952337949,-80.03155047662051,0.08052968043074316,0.4240295780924662,-0.01774908353198179,555427900.0,-1.0
1165,ABBV,2024-10-17,186.80836486816406,189.8298593282705,186.6993918960257,188.7599469971591,4419000.0,-1.872344970703125,1.872344970703125,0.0,29.384762611163495,186.6993918960257,195.5496455729515,1.231297724521418,-98.76870227547857,-0.23774856087669605,0.29167395029863374,-0.021690006731604594,551008900.0,-1.0
1166,ABBV,2024-10-18,187.0956573486328,187.91790524485162,186.40219982056888,187.20463032563146,5607900.0,0.28729248046875,0.0,0.28729248046875,31.7328507661735,186.40219982056888,195.5496455729515,7.580887023935691,-92.41911297606431,-0.46148455136929556,0.14104224996504786,-0.016744254973033112,556616800.0,1.0
1167,ABBV,2024-10-21,184.7973175048828,187.610797421461,184.15339591815575,186.94705844424146,4496500.0,-2.29833984375,2.29833984375,0.0,24.28026095910984,184.15339591815575,194.4166145673319,6.2740706277240825,-93.72592937227591,-0.8148605479647131,-0.050138309620904396,-0.025803714065539163,552120300.0,-1.0
1168,ABBV,2024-10-22,186.99658203125,187.33341720967965,184.4902187231359,184.5793894235603,4210400.0,2.1992645263671875,0.0,2.1992645263671875,39.871756532816505,184.15339591815575,194.4166145673319,27.702675060152593,-72.29732493984741,-0.9069960184308172,-0.22150985138288704,-0.023017470158205655,556330700.0,1.0
1169,ABBV,2024-10-23,186.12481689453125,187.50183081383148,185.74836204359264,186.93714853742355,4266700.0,-0.87176513671875,0.87176513671875,0.0,36.439924164256006,184.15339591815575,194.4166145673319,19.208603497244503,-80.7913965027555,-1.0383883094068267,-0.384885542987675,-0.02557075947617704,552064000.0,-1.0
1170,ABBV,2024-10-24,187.87826538085938,188.69061211764816,186.41209591600352,186.66966152910632,6741800.0,1.753448486328125,0.0,1.753448486328125,47.02254446987253,184.15339591815575,194.4166145673319,36.29338504838957,-63.70661495161043,-0.9896212699868556,-0.5058326883875113,-0.015580367365161107,558805800.0,1.0
1171,ABBV,2024-10-25,186.0950927734375,188.10612710342863,185.42143754022553,187.90798343021103,4017400.0,-1.783172607421875,1.783172607421875,0.0,39.33724155926021,184.15339591815575,194.4166145673319,18.91898557025884,-81.08101442974116,-1.082383127785647,-0.6211427762671384,-0.0321998593681917,554788400.0,-1.0
1172,ABBV,2024-10-28,187.90798950195312,188.36369880234273,185.76817985471627,186.3328470161603,5383700.0,1.812896728515625,0.0,1.812896728515625,49.09675036134594,184.15339591815575,194.4166145673319,36.58300297537524,-63.41699702462476,-0.9981064040964327,-0.6965355018329974,-0.01136246864230328,560172100.0,1.0
1173,ABBV,2024-10-29,187.68014526367188,189.37417700624366,186.7588406276393,188.710437994897,6131500.0,-0.22784423828125,0.22784423828125,0.0,47.97742679099886,184.15339591815575,194.4166145673319,34.36299533381983,-65.63700466618018,-0.9388788087715056,-0.7450041632206992,-0.005302951086254559,554040600.0,-1.0
1174,ABBV,2024-10-30,199.61756896972656,200.45963424016438,186.78855205174403,189.82986397659477,10396400.0,11.937423706054688,0.0,11.937423706054688,78.12555662749864,184.15339591815575,200.45963424016438,94.83593178384206,-5.164068216157947,0.07049716763583547,-0.5819038970493923,0.06856868593974541,564437000.0,1.0
1175,ABBV,2024-10-31,201.96542358398438,205.3832054717137,199.53831472401322,200.08317959859616,8829300.0,2.3478546142578125,0.0,2.3478546142578125,80.6680131575517,184.15339591815575,205.3832054717137,83.9010242691672,-16.098975730832812,1.047808660629272,-0.2559613855136593,0.07947681119954231,573266300.0,1.0
1176,ABBV,2024-11-01,201.64842224121094,202.81739132870817,200.42991723456342,202.46075387356254,4493900.0,-0.3170013427734375,0.3170013427734375,0.0,79.23330974500739,184.15339591815575,205.3832054717137,82.40783450703712,-17.592165492962877,1.7762798524612151,0.1504868620813157,0.09118695532949439,568772400.0,-1.0
1177,ABBV,2024-11-04,198.59719848632812,202.33198315352604,198.34953400127173,201.8861749874321,3531800.0,-3.0512237548828125,3.0512237548828125,0.0,66.16423283107108,184.15339591815575,205.3832054717137,68.03547875327835,-31.964521246721638,2.0833744200031674,0.5370643736656863,0.06203651601043436,565240600.0,-1.0
1178,ABBV,2024-11-05,199.79588317871094,200.52897548549961,196.4970055887627,198.61701294489177,5109300.0,1.1986846923828125,0.0,1.1986846923828125,68.51807432597062,184.15339591815575,205.3832054717137,73.68171259894149,-26.318287401058516,2.3958549891790994,0.908822496768369,0.07345106639877308,570349900.0,1.0
1179,ABBV,2024-11-06,199.32037353515625,204.2241272910538,198.97365232758722,203.86748982973904,7194800.0,-0.4755096435546875,0.4755096435546875,0.0,66.40363457786302,184.15339591815575,205.3832054717137,71.441892018568,-28.558107981432002,2.575440363957199,1.242146070206135,0.06090171277184142,563155100.0,-1.0
1180,ABBV,2024-11-07,198.63681030273438,200.429913801322,197.358868261493,200.06336009888102,4520200.0,-0.683563232421875,0.683563232421875,0.0,63.1701602546546,184.15339591815575,205.3832054717137,68.22206458348244,-31.777935416517565,2.6322621477188477,1.5201692857086777,0.06739413351735113,558634900.0,-1.0
1181,ABBV,2024-11-08,197.63626098632812,200.00393288171523,197.6164435947846,199.2807568109041,4596900.0,-1.00054931640625,1.00054931640625,0.0,58.36980356317259,184.4902187231359,205.3832054717137,62.9208376063661,-37.07916239363391,2.5669674499530686,1.7295289185575562,0.05177146277898892,554038000.0,-1.0
1182,ABBV,2024-11-11,172.8004608154297,176.9017992839943,171.08662677610175,176.9017992839943,20760300.0,-24.835800170898438,24.835800170898438,0.0,18.375786411007752,171.08662677610175,205.3832054717137,4.997099140816664,-95.00290085918334,0.5053540127150313,1.4846939373890513,-0.07928214477529161,533277700.0,-1.0
1183,ABBV,2024-11-12,169.4916534423828,174.97990657501663,169.43221638804752,174.3656884089927,10557000.0,-3.308807373046875,3.308807373046875,0.0,16.62472089911479,169.43221638804752,205.3832054717137,0.1653280086313266,-99.83467199136868,-1.379579656050339,0.9118392187011732,-0.15091815656723362,522720700.0,-1.0
1184,ABBV,2024-11-13,168.7585906982422,171.0271907911672,168.06511802845915,170.06625135402996,8483500.0,-0.733062744140625,0.733062744140625,0.0,16.229376255291356,168.06511802845915,205.3832054717137,1.8582749473362505,-98.14172505266376,-2.899135773207604,0.1496442203194176,-0.16441840537092534,514237200.0,-1.0
1185,ABBV,2024-11-14,168.04530334472656,170.01670287878667,167.01501067018918,168.41184192819708,8442500.0,-0.713287353515625,0.713287353515625,0.0,15.807338284319314,167.01501067018918,205.3832054717137,2.6852779492676073,-97.3147220507324,-4.113533023987827,-0.7029912285420317,-0.16664211166645515,505794700.0,-1.0
1186,ABBV,2024-11-15,163.4486541748047,168.04530627711264,163.18117230629227,168.04530627711264,11265400.0,-4.596649169921875,4.596649169921875,0.0,13.246038309210547,163.18117230629227,205.3832054717137,0.6338127536745854,-99.36618724632541,-5.38479025654172,-1.6393510341419697,-0.17698408929944265,494529300.0,-1.0
1187,ABBV,2024-11-18,164.72659301757812,165.1823022988918,163.26042357045375,164.07275518117842,8341400.0,1.2779388427734375,0.0,1.2779388427734375,17.532520634473286,163.18117230629227,205.3832054717137,3.6619579564524627,-96.33804204354753,-6.217480542377956,-2.5549769357891674,-0.17552558943251328,502870700.0,1.0
1188,ABBV,2024-11-19,165.01390075683594,165.53894825712155,162.2796751608302,163.72604240819098,5246000.0,0.2873077392578125,0.0,0.2873077392578125,18.576155278230345,162.2796751608302,205.3832054717137,6.343391309911676,-93.65660869008833,-6.776099601455513,-3.3992014689224375,-0.17211724105197568,508116700.0,1.0
1189,ABBV,2024-11-20,166.19276428222656,166.34137203734616,164.1024755032935,165.35071413484215,7135600.0,1.178863525390625,0.0,1.178863525390625,23.178835127893507,162.2796751608302,204.2241272910538,9.329217387909875,-90.67078261209012,-7.042503202964269,-4.127861815730805,-0.16333350284401538,515252300.0,1.0
1190,ABBV,2024-11-21,170.1256866455078,170.8488778374815,165.36062429310857,167.01502126659548,6847700.0,3.93292236328125,0.0,3.93292236328125,36.907716643023846,162.2796751608302,204.2241272910538,18.705719317344624,-81.29428068265537,-6.857230130118609,-4.673735478608366,-0.13919801054485348,522100000.0,1.0
1191,ABBV,2024-11-22,175.2969207763672,177.18908108387652,171.87915388094524,172.7113029288976,11328600.0,5.171234130859375,0.0,5.171234130859375,50.36528356679681,162.2796751608302,204.2241272910538,31.03448717156384,-68.96551282843616,-6.221407989898978,-4.983269980866488,0.014447067728621477,533428600.0,1.0
1192,ABBV,2024-11-25,175.4058837890625,178.50664782557007,175.09878226140324,175.36626412456187,12465000.0,0.1089630126953125,0.0,0.1089630126953125,50.62135567293656,162.2796751608302,204.2241272910538,31.294266491977947,-68.70573350802206,-5.643665297946086,-5.115349044282408,0.03489393268967178,545893600.0,1.0
1193,ABBV,2024-11-26,179.44776916503906,179.95299924589642,175.01952719792544,175.43560169679145,6947500.0,4.0418853759765625,0.0,4.0418853759765625,59.55273755214893,162.2796751608302,200.429913801322,45.00127552540926,-54.998724474590745,-4.804273013028222,-5.053133838031571,0.06334005529774922,552841100.0,1.0
1194,ABBV,2024-11-27,181.36965942382812,182.51882627451081,179.20011609324777,179.44778058091694,5271500.0,1.9218902587890625,0.0,1.9218902587890625,63.20422605653236,162.2796751608302,200.00393288171523,50.6040023484127,-49.3959976515873,-3.9385667519153458,-4.830220420808327,0.0792902616966813,558112600.0,1.0
1195,ABBV,2024-11-29,181.22105407714844,181.82535603976612,180.79507840847478,181.42909890070968,2710700.0,-0.1486053466796875,0.1486053466796875,0.0,62.69921987012546,162.2796751608302,182.51882627451081,93.58781309515916,-6.4121869048408415,-3.227277466711115,-4.5096318299888845,0.10873384055727109,555401900.0,-1.0
1196,ABBV,2024-12-02,180.0718994140625,180.9932040497717,177.1890811579081,180.57712952562167,3936600.0,-1.1491546630859375,1.1491546630859375,0.0,58.52671650465515,162.2796751608302,182.51882627451081,87.90993334303275,-12.090066656967249,-2.724891903373276,-4.152683844665763,0.09315621792072681,551465300.0,-1.0
1197,ABBV,2024-12-03,179.80441284179688,181.79562982315704,179.78459545080975,180.57712481165248,4107600.0,-0.267486572265625,0.267486572265625,0.0,57.4990164423803,162.2796751608302,182.51882627451081,86.58830393889822,-13.411696061101786,-2.321570041527224,-3.786461084038055,0.08963191596056008,547357700.0,-1.0
1198,ABBV,2024-12-04,174.81150817871094,178.76422371736794,174.26664328398962,178.41750250526576,6125500.0,-4.9929046630859375,4.9929046630859375,0.0,41.72063824743061,162.2796751608302,182.51882627451081,61.918767973474274,-38.081232026525726,-2.3774148802526156,-3.5046518432809677,0.05185992262483907,541232200.0,-1.0
1199,ABBV,2024-12-05,174.52420043945312,175.06906530773358,171.90886418794685,173.34531511978446,5444200.0,-0.2873077392578125,0.2873077392578125,0.0,40.97409786628424,162.2796751608302,182.51882627451081,60.499203794897596,-39.500796205102404,-2.41699404785291,-3.287120284195356,0.02585449546552332,535788000.0,-1.0
1200,ABBV,2024-12-06,174.5440216064453,175.0888864865145,172.53298723511378,174.3557941827632,4839600.0,0.0198211669921875,0.0,0.0198211669921875,41.05805481125385,162.2796751608302,182.51882627451081,60.597138569339734,-39.402861430660266,-2.418878099769927,-3.1134718473102705,-0.004294993697478433,540627600.0,1.0
1201,ABBV,2024-12-09,174.92047119140625,176.46589508384346,172.7509279900079,173.9496155738579,4394500.0,0.3764495849609375,0.0,0.3764495849609375,42.8397508551672,162.2796751608302,182.51882627451081,62.45714535937985,-37.542854640620156,-2.3627584801095622,-2.9633291738701293,-0.002767367816691846,545022100.0,1.0
1202,ABBV,2024-12-10,174.02886962890625,175.26719199074134,172.20606274018255,173.89017812903032,4089600.0,-0.8916015625,0.8916015625,0.0,39.57088693963377,164.1024755032935,182.51882627451081,53.89989715620852,-46.10010284379148,-2.3629890055311193,-2.8432611402023276,-0.030197642251818757,540932500.0,-1.0
1203,ABBV,2024-12-11,172.7410125732422,174.35578978171276,172.21596509740326,174.31617011699882,9492200.0,-1.2878570556640625,1.2878570556640625,0.0,35.10631434228493,165.36062429310857,182.51882627451081,43.01376267824106,-56.986237321758935,-2.438976002760171,-2.7624041127138965,-0.04757491896934285,531440300.0,-1.0
1204,ABBV,2024-12-12,171.57205200195312,174.26664282304708,170.38326549058596,173.2759848775343,4999500.0,-1.1689605712890625,1.1689605712890625,0.0,31.39639859653923,170.38326549058596,182.51882627451081,9.795892687067852,-90.20410731293215,-2.5639657925694053,-2.7227164486849986,-0.05324437673278071,526440800.0,-1.0
1205,ABBV,2024-12-13,171.7503662109375,173.28588907686094,170.779525639729,171.63149209257264,5471600.0,0.178314208984375,0.0,0.178314208984375,32.64912447904672,170.38326549058596,182.51882627451081,11.265245543184527,-88.73475445681548,-2.618448787371932,-2.7018629164223857,-0.0462122809289095,531912400.0,1.0
1206,ABBV,2024-12-16,170.02662658691406,171.72064319431263,168.93689680957425,170.06624625325347,8157900.0,-1.7237396240234375,1.7237396240234375,0.0,27.124481676298856,168.93689680957425,182.51882627451081,8.0233797425696,-91.9766202574304,-2.76880131698411,-2.7152505965347307,-0.05438012393770286,523754500.0,-1.0
1207,ABBV,2024-12-17,173.74159240722656,174.85112445039474,168.61989272877574,168.98643132527087,7664700.0,3.7149658203125,0.0,3.7149658203125,48.70768944246682,168.61989272877574,182.51882627451081,36.84958749962821,-63.1504125003718,-2.5586950417894343,-2.6839394855856717,-0.006120396663991889,531419200.0,1.0
1208,ABBV,2024-12-18,171.4036407470703,174.8511261404075,171.2055121826239,174.38551570002613,5471600.0,-2.33795166015625,2.33795166015625,0.0,40.08659970347044,168.61989272877574,181.82535603976612,21.080275282562567,-78.91972471743743,-2.5514262117002033,-2.6574368308085785,-0.01788038383516566,525947600.0,-1.0
1209,ABBV,2024-12-19,169.9176483154297,172.25560157886895,168.74866412559004,171.31446447492345,6110500.0,-1.485992431640625,1.485992431640625,0.0,35.480969237146155,168.61989272877574,181.79562982315704,9.849586230795143,-90.15041376920486,-2.635195883964002,-2.6529886414396633,-0.02650548124442198,519837100.0,-1.0
1210,ABBV,2024-12-20,173.93972778320312,175.1483317130998,169.06569239605437,170.18512562051464,18950900.0,4.0220794677734375,0.0,4.0220794677734375,52.518199853009726,168.61989272877574,181.79562982315704,40.37599578922982,-59.62400421077019,-2.349947027095169,-2.592380318570765,-0.005606796057220476,538788000.0,1.0
1211,ABBV,2024-12-23,176.7234649658203,176.98103058203944,172.99859664487195,173.65241938084978,6945600.0,2.7837371826171875,0.0,2.7837371826171875,60.78738102193908,168.61989272877574,178.76422371736794,79.88276650434058,-20.117233495659413,-1.8776169277771828,-2.4494276404120487,0.01548361109659524,545733600.0,1.0
1212,ABBV,2024-12-24,178.31842041015625,178.48683043770598,176.17859573733682,176.74327799109744,2692800.0,1.5949554443359375,0.0,1.5949554443359375,64.8359575978527,168.61989272877574,178.48683043770598,98.29318849963649,-1.7068115003635167,-1.3589274763101287,-2.231327607591665,0.032287687526141085,548426400.0,1.0
1213,ABBV,2024-12-26,177.52589416503906,178.6651598294624,176.96122701768633,177.34758299731928,2759300.0,-0.7925262451171875,0.7925262451171875,0.0,61.21244921939123,168.61989272877574,178.6651598294624,88.65868221318418,-11.341317786815823,-1.0002819657818804,-1.9851184792297079,0.034701701667694484,545667100.0,-1.0
1214,ABBV,2024-12-27,176.34701538085938,177.98161006016198,175.6337404510256,176.2578597936903,2745400.0,-1.1788787841796875,1.1788787841796875,0.0,55.85476655377342,168.61989272877574,178.6651598294624,76.92301831929824,-23.076981680701767,-0.8019342811626302,-1.7484816396162925,0.026763547998939652,542921700.0,-1.0
1215,ABBV,2024-12-30,174.55392456054688,175.68327399815337,173.8703681690039,175.36627132042122,3405700.0,-1.7930908203125,1.7930908203125,0.0,48.41739183574927,168.61989272877574,178.6651598294624,59.07291237049842,-40.927087629501585,-0.7804334053045352,-1.5548719927539412,0.026626994045068297,539516000.0,-1.0
1216,ABBV,2024-12-31,176.0399169921875,176.17860850235024,174.27654702744357,174.70253781195544,3326400.0,1.485992431640625,0.0,1.485992431640625,54.24345112749607,168.61989272877574,178.6651598294624,73.86587324198234,-26.13412675801766,-0.6361534549679391,-1.3711282851967408,0.013228407505175621,542842400.0,1.0
1217,ABBV,2025-01-02,177.76365661621094,178.10047667549117,176.2380349797817,176.99094466080808,4092000.0,1.7237396240234375,0.0,1.7237396240234375,60.252243496837764,168.61989272877574,178.6651598294624,91.0255924086893,-8.974407591310694,-0.37835770102185506,-1.1725741683617636,0.03710548878320319,546934400.0,1.0
1218,ABBV,2025-01-03,179.5270233154297,179.87375962203564,177.12963304518888,177.98159943182318,4380200.0,1.76336669921875,0.0,1.76336669921875,65.58658254766692,168.61989272877574,179.87375962203564,96.91895852425966,-3.0810414757403346,-0.031401773052095905,-0.94433968929983,0.056553130856433764,551314600.0,1.0
1219,ABBV,2025-01-06,178.41749572753906,180.27992232023573,177.58533159437664,179.0911358508838,6302100.0,-1.109527587890625,1.109527587890625,0.0,59.76356781609512,168.61989272877574,180.27992232023573,84.02725672273817,-15.972743277261822,0.1522783261586369,-0.7250160862081366,0.025743215775966943,545012500.0,-1.0
1220,ABBV,2025-01-07,177.85281372070312,180.4681500035665,176.72346430574484,177.95188555839286,5905200.0,-0.5646820068359375,0.5646820068359375,0.0,56.80207399457664,168.61989272877574,180.4681500035665,77.92640535897236,-22.073594641027633,0.24940601216118807,-0.5301316665342717,0.006390485582099981,539107300.0,-1.0
1221,ABBV,2025-01-08,176.8324432373047,177.56553555867853,174.53410954839688,177.5259007757715,4488500.0,-1.0203704833984375,1.0203704833984375,0.0,51.48295589694073,168.74866412559004,180.4681500035665,68.97725033233647,-31.022749667663536,0.24126389269366655,-0.375852554688684,-0.008333279138709404,534618800.0,-1.0
1222,ABBV,2025-01-10,173.53355407714844,175.8814086191938,171.7107470477441,175.2077684581604,5372200.0,-3.29888916015625,3.29888916015625,0.0,38.15452023172766,168.74866412559004,180.4681500035665,40.82849709772914,-59.171502902270866,-0.031023956049097023,-0.30688683496076663,-0.022488776111608266,529246600.0,-1.0
1223,ABBV,2025-01-13,175.08888244628906,176.31728856620077,172.7112944198253,173.52364115249972,4734100.0,1.555328369140625,0.0,1.555328369140625,45.78939991147411,169.06569239605437,180.4681500035665,52.82361274701437,-47.17638725298563,-0.11992956358221818,-0.26949538068505696,-0.007134415809947781,533980700.0,1.0
1224,ABBV,2025-01-14,173.91000366210938,175.1285086906603,172.4636364246193,174.9600986555143,4779100.0,-1.1788787841796875,1.1788787841796875,0.0,41.32742108835707,171.7107470477441,180.4681500035665,25.113114304088207,-74.88688569591179,-0.282259847839498,-0.2720482741159452,-0.003688951136782692,529201600.0,-1.0
1225,ABBV,2025-01-15,171.35000610351562,174.4600067138672,168.72000122070312,173.52000427246094,8048700.0,-2.55999755859375,2.55999755859375,0.0,33.217032089552276,168.72000122070312,180.4681500035665,22.3865472886145,-77.6134527113855,-0.6104413874976728,-0.33972689679229073,-0.026641178709939983,521152900.0,-1.0
1226,ABBV,2025-01-16,173.6999969482422,173.9600067138672,170.52000427246094,171.4499969482422,5236000.0,2.3499908447265625,0.0,2.3499908447265625,44.709831326507675,168.72000122070312,180.4681500035665,42.38962086352881,-57.61037913647119,-0.6731434222659516,-0.406410201887023,-0.022859901429357565,526388900.0,1.0
1227,ABBV,2025-01-17,171.55999755859375,173.99000549316406,171.27000427246094,172.8800048828125,7852500.0,-2.1399993896484375,2.1399993896484375,0.0,37.86325523054192,168.72000122070312,180.4681500035665,24.173990220767628,-75.82600977923238,-0.8853099999935239,-0.5021901615083232,-0.04437786362021856,518536400.0,-1.0
1228,ABBV,2025-01-21,172.61000061035156,175.66000366210938,171.22000122070312,172.16000366210938,7548500.0,1.0500030517578125,0.0,1.0500030517578125,42.820449758279665,168.72000122070312,180.4681500035665,33.11159452902609,-66.8884054709739,-0.9576874456513167,-0.593289618336922,-0.032550031562241566,526084900.0,1.0
1229,ABBV,2025-01-22,169.1999969482422,170.8699951171875,168.05999755859375,170.3000030517578,9465000.0,-3.410003662109375,3.410003662109375,0.0,32.965414268340226,168.05999755859375,180.4681500035665,9.187503092858242,-90.81249690714176,-1.275502688706439,-0.7297322324108254,-0.04865155963205148,516619900.0,-1.0
1230,ABBV,2025-01-23,170.6699981689453,170.69000244140625,168.47999572753906,170.4600067138672,7116200.0,1.470001220703125,0.0,1.470001220703125,39.8510746337308,168.05999755859375,180.4681500035665,21.034562735478165,-78.96543726452182,-1.3927025374404707,-0.8623262934167545,-0.03484906364206897,523736100.0,1.0
1231,ABBV,2025-01-24,170.3000030517578,171.11000061035156,169.25,169.32000732421875,5584900.0,-0.3699951171875,0.3699951171875,0.0,38.69669992973721,168.05999755859375,180.4681500035665,18.052691592063855,-81.94730840793615,-1.4981698067662421,-0.9894949960866521,-0.018633578056916122,518151200.0,-1.0
1232,ABBV,2025-01-27,176.89999389648438,177.4499969482422,172.58999633789062,172.66000366210938,6985200.0,6.5999908447265625,0.0,6.5999908447265625,61.594555354840736,168.05999755859375,180.4681500035665,71.24345366559554,-28.75654633440447,-1.0372327018807255,-0.999042537245467,0.010343954595465998,525136400.0,1.0
1233,ABBV,2025-01-28,174.80999755859375,177.16000366210938,173.72999572753906,176.8000030517578,5603700.0,-2.089996337890625,2.089996337890625,0.0,54.19777816634617,168.05999755859375,180.4681500035665,54.39971849100553,-45.60028150899447,-0.8310026813961144,-0.9654345660755964,0.005175055359282199,519532700.0,-1.0
1234,ABBV,2025-01-29,175.25999450683594,176.9199981689453,174.3000030517578,174.5,3748300.0,0.4499969482421875,0.0,0.4499969482421875,55.52465760002779,168.05999755859375,177.56553555867853,75.74528604459809,-24.254713955401915,-0.6240591460410485,-0.8971594820686869,0.022818723455184653,523281000.0,1.0
1235,ABBV,2025-01-30,175.64999389648438,176.1199951171875,173.97999572753906,176.00999450683594,5209200.0,0.3899993896484375,0.0,0.3899993896484375,56.77682907663736,168.05999755859375,177.4499969482422,80.8306371804226,-19.1693628195774,-0.42370104998127545,-0.8024677956512046,0.011226234787000244,528490200.0,1.0
1236,ABBV,2025-01-31,183.89999389648438,191.77000427246094,183.6699981689453,187.3000030517578,11928300.0,8.25,0.0,8.25,74.38169750788538,168.05999755859375,191.77000427246094,66.8072199601122,-33.192780039887786,0.3962228264185512,-0.5627296712372535,0.07192816806654534,540418500.0,1.0
1237,ABBV,2025-02-03,190.13999938964844,191.66000366210938,182.14999389648438,183.17999267578125,9830000.0,6.2400054931640625,0.0,6.2400054931640625,81.09996963953998,168.05999755859375,191.77000427246094,93.12524495465804,-6.874755045341951,1.5318761840051138,-0.1438085001887799,0.1015584190794887,550248500.0,1.0
1238,ABBV,2025-02-04,189.9499969482422,191.14999389648438,187.0500030517578,187.6300048828125,7377800.0,-0.19000244140625,0.19000244140625,0.0,80.35956870970247,168.05999755859375,191.77000427246094,92.32388524312695,-7.67611475687305,2.3890189197342124,0.3627569837958188,0.12263593601805667,542870700.0,-1.0
1239,ABBV,2025-02-05,191.75,193.3800048828125,189.9199981689453,190.52000427246094,6449600.0,1.8000030517578125,0.0,1.8000030517578125,82.14173227291583,168.05999755859375,193.3800048828125,93.5623838415979,-6.437616158402094,3.1769341963603495,0.9255924263087252,0.12351322468631953,549320300.0,1.0
1240,ABBV,2025-02-06,192.97000122070312,194.49000549316406,190.55999755859375,191.89999389648438,4586400.0,1.220001220703125,0.0,1.220001220703125,83.32503636357004,168.05999755859375,194.49000549316406,94.24894507703578,-5.751054922964211,3.855364391421432,1.5115468193312667,0.1331180138737602,553906700.0,1.0
1241,ABBV,2025-02-07,190.60000610351562,193.86000061035156,190.44000244140625,193.16000366210938,3805900.0,-2.3699951171875,2.3699951171875,0.0,72.5497666646238,168.05999755859375,194.49000549316406,85.28188338316637,-14.71811661683362,4.153902803942401,2.0400180162534935,0.07744495579263844,550100800.0,-1.0
1242,ABBV,2025-02-10,190.33999633789062,191.4600067138672,189.08999633789062,191.4600067138672,3685700.0,-0.260009765625,0.260009765625,0.0,71.38127120171343,168.05999755859375,194.49000549316406,84.29811612033137,-15.701883879668637,4.319720977133301,2.495958608429455,0.08883930550992347,546415100.0,-1.0
1243,ABBV,2025-02-11,191.8300018310547,191.92999267578125,188.25999450683594,189.8000030517578,3977000.0,1.4900054931640625,0.0,1.4900054931640625,74.1357361427841,168.47999572753906,194.49000549316406,89.77315392774341,-10.226846072256587,4.519268747867073,2.900620636316979,0.09454529181542592,550392100.0,1.0
1244,ABBV,2025-02-12,193.0,194.3699951171875,190.38999938964844,190.5,4525000.0,1.1699981689453125,0.0,1.1699981689453125,76.21027489975391,169.25,194.49000549316406,94.09665147035085,-5.903348529649138,4.717441142997501,3.2639847376530837,0.09877601313063811,554917100.0,1.0
1245,ABBV,2025-02-13,193.4499969482422,194.27999877929688,191.42999267578125,194.27999877929688,4108900.0,0.4499969482421875,0.0,0.4499969482421875,77.0279730966861,172.58999633789062,194.49000549316406,95.25110451987439,-4.74889548012561,4.854841594962352,3.5821561091149374,0.05193041527306108,559026000.0,1.0
1246,ABBV,2025-02-14,192.8699951171875,195.17999267578125,192.77999877929688,193.9499969482422,3976900.0,-0.5800018310546875,0.5800018310546875,0.0,73.28196734933812,173.72999572753906,195.17999267578125,89.2307790804462,-10.769220919553803,4.860897739238595,3.837904435139669,0.014357819166416208,555049100.0,-1.0
1247,ABBV,2025-02-18,196.25,197.02000427246094,190.6699981689453,192.0,6065500.0,3.3800048828125,0.0,3.3800048828125,79.86593062531611,173.97999572753906,197.02000427246094,96.65796880691414,-3.3420311930858633,5.079877754730802,4.0862990990578965,0.03316663939444253,561114600.0,1.0
1248,ABBV,2025-02-19,197.35000610351562,198.11000061035156,196.00999450683594,196.7899932861328,4888700.0,1.100006103515625,0.0,1.100006103515625,81.57124550685444,173.97999572753906,198.11000061035156,96.85041710299332,-3.1495828970066726,5.281302723790219,4.325299824004361,0.029204725442063317,566003300.0,1.0
1249,ABBV,2025-02-20,200.8800048828125,201.36000061035156,196.8300018310547,198.0,5067000.0,3.529998779296875,0.0,3.529998779296875,85.97098966631815,182.14999389648438,201.36000061035156,97.50132451961838,-2.4986754803816202,5.660523867426974,4.592344632688884,0.040990846308087914,571070300.0,1.0
1250,ABBV,2025-02-21,202.0800018310547,203.97999572753906,200.02000427246094,200.32000732421875,5889400.0,1.1999969482421875,0.0,1.1999969482421875,87.17224565708992,182.14999389648438,203.97999572753906,91.29640981623052,-8.703590183769487,5.988853307829174,4.871646367716942,0.060230825602934246,576959700.0,1.0
1251,ABBV,2025-02-24,204.0800018310547,205.5,201.27999877929688,201.8300018310547,6305000.0,2.0,0.0,2.0,88.98590282309846,187.0500030517578,205.5,92.30353168659683,-7.696468313403174,6.337386592385599,5.164794412650674,0.07218664367720629,583264700.0,1.0
1252,ABBV,2025-02-25,204.13999938964844,206.00999450683594,202.35000610351562,205.17999267578125,7746800.0,0.05999755859375,0.0,0.05999755859375,89.03954232554132,188.25999450683594,206.00999450683594,89.46481624119718,-10.535183758802818,6.543019180773314,5.440439366275203,0.06417138842252212,591011500.0,1.0
1253,ABBV,2025-02-26,203.00999450683594,203.8300018310547,201.42999267578125,203.58999633789062,4766700.0,-1.1300048828125,1.1300048828125,0.0,80.51790669434472,188.25999450683594,206.00999450683594,83.09859154929578,-16.901408450704224,6.539420173265569,5.660235527673277,0.051865256512103386,586244800.0,-1.0
1254,ABBV,2025-02-27,205.02000427246094,206.8000030517578,202.25,203.05999755859375,5696900.0,2.010009765625,0.0,2.010009765625,83.7164663294326,188.25999450683594,206.8000030517578,90.3991480101857,-9.600851989814311,6.6224197905869175,5.8526723802560054,0.0598087749120737,591941700.0,1.0
1255,ABBV,2025-02-28,209.02999877929688,209.60000610351562,204.41000366210938,205.1199951171875,13132700.0,4.0099945068359375,0.0,4.0099945068359375,88.18261917242296,188.25999450683594,209.60000610351562,97.32892683007053,-2.671073169929476,6.931864411078209,6.068510786420447,0.08378702790079173,605074400.0,1.0
1256,ABBV,2025-03-03,211.3800048828125,212.3000030517578,208.91000366210938,209.97999572753906,4136142.0,2.350006103515625,0.0,2.350006103515625,90.03142436691564,188.25999450683594,212.3000030517578,96.17305390209752,-3.8269460979024887,7.282776046090248,6.311363838354408,0.0770955662818471,609210542.0,1.0
