,symbol,timestamp,close,high,low,open,volume,change_in_price,down_days,up_days,RSI,low_14,high_14,k_percent,r_percent,MACD,MACD_EMA,Price_Rate_Of_Change,On Balance Volume,Prediction
14,ACGL,2020-03-20,24.694833755493164,26.25430855175586,24.295456307067898,25.674259877837144,4155200.0,-1.0364799499511719,1.0364799499511719,0.0,24.13690278372424,24.295456307067898,40.99323603060698,2.3917997185114284,-97.60820028148856,-1.8312606347809677,-1.2542401191839838,-0.2914052600792134,-17255400.0,-1.0
15,ACGL,2020-03-23,22.117900848388672,24.409566245859533,21.4332545342451,24.409566245859533,3340900.0,-2.576932907104492,2.576932907104492,0.0,19.95314610304669,21.4332545342451,40.99323603060698,3.5002400910804212,-96.49975990891959,-2.0796018488382373,-1.4240934102289453,-0.3851440507836025,-20596300.0,-1.0
16,ACGL,2020-03-24,24.343002319335938,24.713852159386075,23.10683316301051,23.44915720840755,4464800.0,2.2251014709472656,0.0,2.2251014709472656,31.741108110868353,21.4332545342451,40.18497045297369,15.517234783749457,-84.48276521625054,-2.1054895469897517,-1.5635120666261,-0.28651061528918287,-16131500.0,1.0
17,ACGL,2020-03-25,24.457109451293945,25.11322994248448,23.44915752092957,24.72336169167293,6418400.0,0.11410713195800781,0.0,0.11410713195800781,32.3307612656227,21.4332545342451,38.920278653425555,17.291992602287095,-82.7080073977129,-2.092273452666003,-1.6712043556448632,-0.16166886264983393,-9713100.0,1.0
18,ACGL,2020-03-26,28.213159561157227,28.5935186118137,24.276440212896457,24.91354230288168,3721400.0,3.7560501098632812,0.0,3.7560501098632812,49.048016774500994,21.4332545342451,36.53352059299357,44.89924217582994,-55.10075782417005,-1.815721845646891,-1.7005304877496508,-0.09459874361201448,-5991700.0,1.0
19,ACGL,2020-03-27,27.642620086669922,28.698118039543413,26.72024916183765,26.83435597022153,3075100.0,-0.5705394744873047,0.5705394744873047,0.0,47.01243451190918,21.4332545342451,36.219724233490886,41.99356356670816,-58.00643643329183,-1.6178499262947383,-1.6838015034006055,0.06718063450025658,-9066800.0,-1.0
20,ACGL,2020-03-30,29.040441513061523,29.1260207107956,26.663195226020928,27.718691344154365,2062700.0,1.3978214263916016,0.0,1.3978214263916016,52.57629909630142,21.4332545342451,35.27833409928907,54.94505786751154,-45.05494213248846,-1.3530992094696899,-1.6170453275689696,0.010589060680923135,-7004100.0,1.0
21,ACGL,2020-03-31,27.062570571899414,28.679098755290404,26.65368573840166,28.679098755290404,5591700.0,-1.9778709411621094,1.9778709411621094,0.0,44.882001732096064,21.4332545342451,32.216442800877864,52.20456045521835,-47.79543954478165,-1.2646719342743467,-1.546046772036642,0.03528553425747827,-12595800.0,-1.0
22,ACGL,2020-04-01,24.742380142211914,26.08314692204961,24.276440080977785,25.931003302613775,1982300.0,-2.3201904296875,2.3201904296875,0.0,37.46143675846043,21.4332545342451,31.237015890026555,33.753632793349894,-66.2463672066501,-1.3387285444794195,-1.504336914986524,-0.038433077088605105,-14578100.0,-1.0
23,ACGL,2020-04-02,25.02764892578125,25.892966439748527,24.409565246332484,24.409565246332484,2276400.0,0.28526878356933594,0.0,0.28526878356933594,38.8946877390222,21.4332545342451,29.1260207107956,46.724342181265996,-53.275657818734004,-1.3608340251897069,-1.4755001592986254,0.013477117261988303,-12301700.0,1.0
24,ACGL,2020-04-03,23.401613235473633,25.198810863873128,23.24946961686283,24.713852399415565,2294100.0,-1.6260356903076172,1.6260356903076172,0.0,33.8000284623095,21.4332545342451,29.1260207107956,25.587138047021206,-74.41286195297879,-1.4750415844191735,-1.4754080965193888,0.058039521737818234,-14595800.0,-1.0
25,ACGL,2020-04-06,25.702787399291992,26.035600427108733,24.685324469254468,24.742379685761602,2901000.0,2.3011741638183594,0.0,2.3011741638183594,45.46464180631748,21.4332545342451,29.1260207107956,55.5006192448889,-44.4993807551111,-1.3850796281793478,-1.4572876371233126,0.05585938259045231,-11694800.0,1.0
26,ACGL,2020-04-07,26.511049270629883,27.728199998448126,26.216271244702515,27.27176915565189,2842900.0,0.8082618713378906,0.0,0.8082618713378906,49.099481487574835,21.4332545342451,29.1260207107956,66.00739733729574,-33.992602662704265,-1.2415103842161734,-1.4140275901664368,0.083981298911318,-8851900.0,1.0
27,ACGL,2020-04-08,27.281278610229492,27.614093449644617,26.102164681934592,26.739266752690988,1807000.0,0.7702293395996094,0.0,0.7702293395996094,52.57507975667564,21.4332545342451,29.1260207107956,76.0197819844135,-23.98021801558651,-1.0600197935428852,-1.3430888152952405,-0.033030010300962975,-7044900.0,1.0
28,ACGL,2020-04-09,29.477853775024414,29.639506594080412,27.671146970907074,27.889853192660784,2283700.0,2.196575164794922,0.0,2.196575164794922,61.275939596023136,21.4332545342451,29.639506594080412,98.03012608097681,-1.96987391902318,-0.7477440300797085,-1.2238353224100502,0.06639145213443398,-4761200.0,1.0
29,ACGL,2020-04-13,27.785253524780273,29.230619680468156,27.557038102360337,29.230619680468156,1103000.0,-1.6926002502441406,1.6926002502441406,0.0,52.68231032588422,23.10683316301051,29.639506594080412,71.61570850180314,-28.384291498196852,-0.6182171929721214,-1.1025615668847852,-0.043222069737359314,-5864200.0,-1.0
30,ACGL,2020-04-14,27.81378173828125,28.983386483783715,27.452441098339634,28.317758607323892,3814800.0,0.028528213500976562,0.0,0.028528213500976562,52.811015305512406,23.24946961686283,29.639506594080412,71.42857134773361,-28.571428652266402,-0.5078037077337569,-0.9834920743407575,0.027758307895624057,-2049400.0,1.0
31,ACGL,2020-04-15,26.0070743560791,27.34784109692901,25.969037545478702,27.34784109692901,1815900.0,-1.8067073822021484,1.8067073822021484,0.0,44.054635669484156,23.24946961686283,29.639506594080412,43.15475401860691,-56.84524598139309,-0.5486506682731154,-0.8964548351218928,0.05111449289025938,-3865300.0,-1.0
32,ACGL,2020-04-16,25.189302444458008,25.892967155842726,24.75188998077091,25.759841938841443,3566600.0,-0.8177719116210938,0.8177719116210938,0.0,40.54375319370623,23.24946961686283,29.639506594080412,30.357145576954725,-69.64285442304528,-0.6347961538961506,-0.8440899086615151,0.0064589973735103,-7431900.0,-1.0
33,ACGL,2020-04-17,25.81689453125,26.663195449853582,25.417517079126682,26.2352903891161,2150100.0,0.6275920867919922,0.0,0.6275920867919922,44.46298025305453,23.24946961686283,29.639506594080412,40.17856114981523,-59.82143885018477,-0.6480927333679816,-0.8048705870441729,0.10321003391830841,-5281800.0,1.0
34,ACGL,2020-04-20,25.388992309570312,25.484080714734453,24.59023737306506,25.160775058830183,1890300.0,-0.4279022216796875,0.4279022216796875,0.0,42.27088575741319,23.24946961686283,29.639506594080412,33.482164506019764,-66.51783549398024,-0.6830478902424488,-0.7804961602416628,-0.012208601535968922,-7172100.0,-1.0
35,ACGL,2020-04-21,24.04822540283203,24.799434320544293,23.943625981067704,24.44760105605205,1998000.0,-1.3407669067382812,1.3407669067382812,0.0,35.8761427807857,23.24946961686283,29.639506594080412,12.500018212993268,-87.49998178700673,-0.803351985132597,-0.785068809129253,-0.09289801556539212,-9170100.0,-1.0
36,ACGL,2020-04-22,23.6773738861084,24.751890279335775,23.658355479537363,24.58072824758663,1992000.0,-0.3708515167236328,0.3708515167236328,0.0,34.2237836255198,23.24946961686283,29.639506594080412,6.696428686894581,-93.30357131310542,-0.9162435911035907,-0.811310578276896,-0.13210175283975734,-11162100.0,-1.0
37,ACGL,2020-04-23,23.068798065185547,24.152821785965482,23.04027045696161,23.81049955575312,1509800.0,-0.6085758209228516,0.6085758209228516,0.0,31.47856943339262,23.04027045696161,29.639506594080412,0.4322865197000007,-99.5677134803,-1.0402031493518642,-0.8570986022924197,-0.21741934669847107,-12671900.0,-1.0
38,ACGL,2020-04-24,22.47924041748047,23.51571994868734,22.308078393803005,23.33505053586779,1955800.0,-0.5895576477050781,0.5895576477050781,0.0,28.888383473736113,22.308078393803005,29.639506594080412,2.334634112231881,-97.66536588776812,-1.170147348691657,-0.9197187561299648,-0.1909650780248464,-14627700.0,-1.0
39,ACGL,2020-04-27,23.439647674560547,23.629828100138322,22.593348589498852,22.802545606678443,3080700.0,0.9604072570800781,0.0,0.9604072570800781,38.41365663495384,22.308078393803005,29.639506594080412,15.434499934333749,-84.56550006566626,-1.1850575534152306,-0.9727935704399231,-0.1572649884463716,-11547000.0,1.0
40,ACGL,2020-04-28,23.534738540649414,24.285949247470008,23.09732608885135,23.86755338780164,2221300.0,0.09509086608886719,0.0,0.09509086608886719,39.34188971341191,22.308078393803005,29.639506594080412,16.73153051952408,-83.26846948047591,-1.1758465337433464,-1.0134084820188092,-0.09506397303977343,-9325700.0,1.0
41,ACGL,2020-04-29,24.323984146118164,24.723361598331316,23.858044087485318,24.266930742571997,1735600.0,0.78924560546875,0.0,0.78924560546875,46.99304097230129,22.308078393803005,29.639506594080412,27.496767304341617,-72.50323269565838,-1.0944864927592661,-1.029625463755133,-0.0343526106071359,-7590100.0,1.0
42,ACGL,2020-04-30,22.8500919342041,23.839025445203596,22.831073528645753,23.667863422568402,2052100.0,-1.4738922119140625,1.4738922119140625,0.0,36.95020768203895,22.308078393803005,29.230619680468156,7.8296902532769925,-92.170309746723,-1.1318507590803613,-1.0500719143334982,-0.11491709792805405,-9642200.0,-1.0
43,ACGL,2020-05-01,21.975265502929688,22.479240560639575,21.680485654187866,22.27955274087415,2156500.0,-0.8748264312744141,0.8748264312744141,0.0,32.23259716350093,21.680485654187866,28.983386483783715,4.036476129419593,-95.9635238705804,-1.215744949665563,-1.0832083255177398,-0.1344569632782877,-11798700.0,-1.0
44,ACGL,2020-05-04,22.631383895874023,22.850091932387713,21.30963554248838,21.81361240757473,2242200.0,0.6561183929443359,0.0,0.6561183929443359,38.975091069494226,21.30963554248838,27.34784109692901,21.889754190524382,-78.11024580947561,-1.2166935444280043,-1.1099065321706987,-0.058916676104971755,-9556500.0,1.0
45,ACGL,2020-05-05,22.574331283569336,24.400056565987754,22.52678708170697,23.430139612957177,3510400.0,-0.0570526123046875,0.0570526123046875,0.0,38.589866282825184,21.30963554248838,26.663195449853582,23.623453607776785,-76.37654639222322,-1.2079387029856967,-1.1295136495420242,-0.04658635741636119,-13066900.0,-1.0
46,ACGL,2020-05-06,22.270044326782227,23.087817667994777,22.174954108132734,22.669421794154047,2981400.0,-0.3042869567871094,0.3042869567871094,0.0,36.377218521644096,21.30963554248838,26.663195449853582,17.93962897421876,-82.06037102578124,-1.210930563902906,-1.1457974863413196,-0.03462485284869543,-16048300.0,-1.0
47,ACGL,2020-05-07,23.496702194213867,23.66786422263501,22.64089386580319,22.64089386580319,3098000.0,1.2266578674316406,0.0,1.2266578674316406,49.77290776382401,21.30963554248838,25.484080714734453,52.391792477387575,-47.60820752261242,-1.1038241268610633,-1.1374026272336546,0.04526228457177717,-12950300.0,1.0
48,ACGL,2020-05-08,24.675817489624023,24.732870893382824,23.696391354340435,23.905588377252702,3114300.0,1.1791152954101562,0.0,1.1791152954101562,59.281654257645876,21.30963554248838,24.799434320544293,96.45776622716528,-3.5422337728347117,-0.9152642542726177,-1.0929741600111056,0.0527384128049464,-9836000.0,1.0
49,ACGL,2020-05-11,24.019697189331055,24.43809305217526,23.924606973180776,24.343002836024983,2391000.0,-0.6561203002929688,0.6561203002929688,0.0,52.8568273339852,21.30963554248838,24.751890279335775,78.72925898926054,-21.27074101073946,-0.8084223363640213,-1.0360629830182282,0.020606077600735517,-12227000.0,-1.0
50,ACGL,2020-05-12,22.488750457763672,24.09576952317332,22.469732051381296,23.91509828993086,2466300.0,-1.5309467315673828,1.5309467315673828,0.0,40.917609338148885,21.30963554248838,24.732870893382824,34.44445953642088,-65.55554046357912,-0.8353892327666728,-0.9959277747048494,-0.07544955124661912,-14693300.0,-1.0
51,ACGL,2020-05-13,21.14798355102539,22.65040318866179,20.97682152169927,22.65040318866179,2321800.0,-1.3407669067382812,1.3407669067382812,0.0,33.31367377687725,20.97682152169927,24.732870893382824,4.556969634544504,-95.4430303654555,-0.9521065328417286,-0.987163446275473,-0.07449022034921615,-17015100.0,-1.0
52,ACGL,2020-05-14,21.728031158447266,21.842137963149423,19.902305959958117,20.701060847653054,2519900.0,0.580047607421875,0.0,0.580047607421875,38.97471428044,19.902305959958117,24.732870893382824,37.79527288529318,-62.20472711470681,-0.9871067362465169,-0.9871521041867993,-0.011250573716593326,-14495200.0,1.0
53,ACGL,2020-05-15,21.851648330688477,21.908703549776007,21.128965212168602,21.58539789639356,2631500.0,0.12361717224121094,0.0,0.12361717224121094,40.222557072867666,19.902305959958117,24.732870893382824,40.354335312667914,-59.645664687332086,-0.9935292084695355,-0.9884275324995089,-0.03445372889139586,-11863700.0,1.0
54,ACGL,2020-05-18,23.163888931274414,23.363576753380908,22.697948865997574,22.697948865997574,1811200.0,1.3122406005859375,0.0,1.3122406005859375,52.19551088749259,19.902305959958117,24.732870893382824,67.5197004132588,-32.48029958674118,-0.8839436667507528,-0.9675306616191622,0.026116284035141435,-10052500.0,1.0
55,ACGL,2020-05-19,23.08781623840332,23.33505006610532,22.517276775529076,22.945180012413545,2368800.0,-0.07607269287109375,0.07607269287109375,0.0,51.50546101711206,19.902305959958117,24.732870893382824,65.94488061641238,-34.05511938358761,-0.7940012846414248,-0.9328246563730328,0.036720713242480274,-12421300.0,-1.0
56,ACGL,2020-05-20,25.236846923828125,25.43653473717254,22.926163291157334,23.11634190190988,3960300.0,2.1490306854248047,0.0,2.1490306854248047,66.10983022809478,19.902305959958117,25.43653473717254,96.39176800629255,-3.6082319937074407,-0.5450289583006587,-0.8552652846113094,0.07405910477270172,-8461000.0,1.0
57,ACGL,2020-05-21,26.10216522216797,26.330380650397267,24.837470257171226,25.23684770999625,3938500.0,0.8653182983398438,0.0,0.8653182983398438,70.26962188030745,19.902305959958117,26.330380650397267,96.44970789513793,-3.5502921048620664,-0.27548445551203216,-0.7393088411309342,0.05780346418689919,-4522500.0,1.0
58,ACGL,2020-05-22,26.91042709350586,27.176679329097375,26.18774582233384,26.406452044233134,3130700.0,0.8082618713378906,0.0,0.8082618713378906,73.74310585208923,19.902305959958117,27.176679329097375,96.33986019028028,-3.6601398097197224,0.0026489481831895034,-0.5909169990058141,0.12034830753231951,-1391800.0,1.0
59,ACGL,2020-05-26,27.94690704345703,28.622045938702488,27.471457781397838,28.28923109252205,2573700.0,1.0364799499511719,0.0,1.0364799499511719,77.6131397931274,19.902305959958117,28.622045938702488,92.25735059885723,-7.742649401142759,0.30242419688556055,-0.4122484860188397,0.24270608524668247,1181900.0,1.0
60,ACGL,2020-05-27,28.450883865356445,29.24012956647279,28.032488007627602,29.00240493585106,2916100.0,0.5039768218994141,0.0,0.5039768218994141,79.32298511993098,19.902305959958117,29.24012956647279,91.54786238877212,-8.452137611227888,0.5736729534557305,-0.21506395637639578,0.3453237182973392,4098000.0,1.0
61,ACGL,2020-05-28,27.614093780517578,28.840751923271796,27.385876540582156,28.726643303304087,2077800.0,-0.8367900848388672,0.8367900848388672,0.0,69.19766124879135,19.902305959958117,29.24012956647279,82.58656562305609,-17.41343437694392,0.7133930505946395,-0.029372372856413562,0.270897191703537,2020200.0,-1.0
62,ACGL,2020-05-29,26.8343563079834,27.42391420437089,26.530069063536324,27.148152755531328,8330500.0,-0.7797374725341797,0.7797374725341797,0.0,60.84686532233469,19.902305959958117,29.24012956647279,74.23625290146875,-25.763747098531248,0.7529617220707223,0.12709456889887752,0.2280243532153683,-6310300.0,-1.0
63,ACGL,2020-06-01,27.6711483001709,27.842310330181274,26.501543513360076,27.053064602451812,2089200.0,0.8367919921875,0.0,0.8367919921875,65.9370723138118,19.902305959958117,29.24012956647279,83.19757009323601,-16.802429906764,0.8416721724209779,0.2700101793128802,0.19458128910344885,-4221100.0,1.0
64,ACGL,2020-06-02,28.888296127319336,29.12602075639558,27.690165592826656,27.95641601662726,3248300.0,1.2171478271484375,0.0,1.2171478271484375,72.03817272838872,19.902305959958117,29.24012956647279,96.23216871533116,-3.767831284668844,0.9980552487527063,0.4156192663210896,0.25123553605159654,-972800.0,1.0
65,ACGL,2020-06-03,30.761566162109375,31.189471228418277,29.42080118629653,29.572944806829693,2393500.0,1.873270034790039,0.0,1.873270034790039,78.78587943889221,19.902305959958117,31.189471228418277,96.2089235327793,-3.7910764672207096,1.2577537902995743,0.584046238779714,0.21891479767486022,1420700.0,1.0
66,ACGL,2020-06-04,31.179964065551758,31.351126093318324,30.3526815359117,30.790095808392373,2382300.0,0.4183979034423828,0.0,0.4183979034423828,80.02796089267002,21.128965212168602,31.351126093318324,98.3255788110105,-1.6744211889894989,1.480058410305702,0.763248730678372,0.19453554140678464,3803000.0,1.0
67,ACGL,2020-06-05,33.262428283691406,33.7473885382052,32.558765442186825,33.22439147404526,3437900.0,2.0824642181396484,0.0,2.0824642181396484,85.05365457349673,22.517276775529076,33.7473885382052,95.68160794155598,-4.318392058444025,1.8026354858865723,0.9711261351673895,0.23604237748119727,7240900.0,1.0
68,ACGL,2020-06-08,33.899532318115234,34.00412810407797,33.17684744080102,33.966094921632354,1825900.0,0.6371040344238281,0.0,0.6371040344238281,86.27300825376521,22.517276775529076,34.00412810407797,99.08943031496561,-0.9105696850343912,2.08538281782495,1.1939775175367724,0.21299764104134877,9066800.0,1.0
69,ACGL,2020-06-09,32.691890716552734,33.224391543147,32.54925449377794,32.88207113778918,1521000.0,-1.2076416015625,1.2076416015625,0.0,73.21006378768254,22.926163291157334,34.00412810407797,88.15452648852317,-11.845473511476817,2.187187925838572,1.3926196318837827,0.14906415109164328,7545800.0,-1.0
70,ACGL,2020-06-10,31.24652671813965,32.302024681751234,31.08487207951036,32.11184424758328,2501100.0,-1.445363998413086,1.445363998413086,0.0,60.54924132349064,24.837470257171226,34.00412810407797,69.91704684528108,-30.082953154718922,2.1271586581967057,1.5395274564853667,0.13154271751567825,5044700.0,-1.0
71,ACGL,2020-06-11,28.812225341796875,30.51433461700489,28.745662733482828,29.95330432736499,2310600.0,-2.4343013763427734,2.4343013763427734,0.0,45.31874577324993,26.18774582233384,34.00412810407797,33.57665253390618,-66.42334746609383,1.8623925588897912,1.6041004837665849,0.07370659504975885,2734100.0,-1.0
72,ACGL,2020-06-12,29.107004165649414,30.333662308610823,28.49842788187714,30.1815186910915,2318800.0,0.29477882385253906,0.0,0.29477882385253906,47.17531888383525,26.501543513360076,34.00412810407797,34.7275078446004,-65.2724921553996,1.6571644665603031,1.6147132812194547,0.051889999283826205,5052900.0,1.0
73,ACGL,2020-06-15,29.411291122436523,29.687050746445795,27.851818150769695,27.994452564132764,1914700.0,0.3042869567871094,0.0,0.3042869567871094,49.22850583298176,26.501543513360076,34.00412810407797,38.78326960386893,-61.21673039613107,1.5016831048590085,1.5921072444237214,0.018104044378809858,6967600.0,1.0
74,ACGL,2020-06-16,29.68705177307129,32.16889935715078,29.306692719718026,30.942239369679598,2891600.0,0.2757606506347656,0.0,0.2757606506347656,51.211432015244014,26.501543513360076,34.00412810407797,42.45881164275421,-57.54118835724579,1.3846850860949331,1.5506228105211275,-0.034930418801680574,9859200.0,1.0
75,ACGL,2020-06-17,29.20209312438965,29.962813040218858,29.14503972015334,29.62999819039952,1576700.0,-0.4849586486816406,0.4849586486816406,0.0,47.450883256831645,26.501543513360076,34.00412810407797,35.994923860914,-64.005076139086,1.2386539845076925,1.4882290426270284,-0.06343403529920355,8282500.0,-1.0
76,ACGL,2020-06-18,29.049949645996094,29.47785471409811,28.584009579448917,28.726643997584578,2351800.0,-0.1521434783935547,0.1521434783935547,0.0,46.222223383272386,26.501543513360076,34.00412810407797,33.96704298127974,-66.03295701872027,1.0980178423131584,1.4101867998711155,-0.12664374957136526,5930700.0,-1.0
77,ACGL,2020-06-19,27.889854431152344,29.639507910268005,27.889854431152344,29.639507910268005,5111600.0,-1.16009521484375,1.16009521484375,0.0,37.6460268815864,27.690165592826656,34.00412810407797,3.1626547983116433,-96.83734520168835,0.8829878141826413,1.3047469998225458,-0.17727907956274191,819100.0,-1.0
78,ACGL,2020-06-22,28.25119400024414,28.764680068739022,27.395385699780984,27.709182137073974,2698200.0,0.3613395690917969,0.0,0.3613395690917969,41.5440331469427,27.395385699780984,34.00412810407797,12.949639252192854,-87.05036074780715,0.7332192500754147,1.1904414473486142,-0.13583480854046037,3517300.0,1.0
79,ACGL,2020-06-23,28.10856056213379,28.859771285389247,27.918381940811113,28.783699474121168,1737400.0,-0.14263343811035156,0.14263343811035156,0.0,40.39390050826624,27.395385699780984,34.00412810407797,10.791385391101041,-89.20861460889896,0.5961680524706203,1.071586766273035,-0.10042607885068278,1779900.0,-1.0
80,ACGL,2020-06-24,27.053064346313477,28.260704120750976,26.729758695731615,28.10856049855893,2497300.0,-1.0554962158203125,1.0554962158203125,0.0,32.67093533153242,26.729758695731615,34.00412810407797,4.444449167111476,-95.55555083288853,0.39795274317701157,0.936859959749497,-0.0610560612592268,-717400.0,-1.0
81,ACGL,2020-06-25,27.46194839477539,27.585566217752902,26.634667699996626,26.634667699996626,1555700.0,0.40888404846191406,0.0,0.40888404846191406,37.971824075383786,26.634667699996626,34.00412810407797,11.225797404659382,-88.77420259534063,0.27068546689967476,0.8036250596729361,-0.05651752277602773,838300.0,1.0
82,ACGL,2020-06-26,26.339889526367188,27.538020056276633,26.282834309746754,27.17667941948878,4415300.0,-1.1220588684082031,1.1220588684082031,0.0,30.39465877932348,26.282834309746754,33.224391543147,0.8219368464745164,-99.17806315352549,0.07852207409662171,0.6586044612457796,-0.1044293357705165,-3577000.0,-1.0
83,ACGL,2020-06-29,26.976991653442383,27.16717026811871,26.273325156685537,26.663195216216216,1438500.0,0.6371021270751953,0.0,0.6371021270751953,38.442306537017195,26.273325156685537,32.302024681751234,11.671945065949815,-88.32805493405019,-0.022176049926024177,0.5224483580260565,-0.09128761388448703,-2138500.0,1.0
84,ACGL,2020-06-30,27.243242263793945,27.528512908309718,26.777302206149347,26.777302206149347,2012500.0,0.2662506103515625,0.0,0.2662506103515625,41.693003792939535,26.273325156685537,32.16889935715078,16.45161394172375,-83.54838605827625,-0.07960551956761819,0.4020375818101908,-0.067079125193244,-126000.0,1.0
85,ACGL,2020-07-01,26.767793655395508,27.60458538992648,26.606140830340323,27.290788942901127,1279000.0,-0.4754486083984375,0.4754486083984375,0.0,37.60169309319815,26.273325156685537,32.16889935715078,8.387113483720556,-91.61288651627945,-0.16157249718990485,0.28931556548807896,-0.07855972276754464,-1405000.0,-1.0
86,ACGL,2020-07-02,26.710739135742188,27.927889874397813,26.62515812524402,27.461948011154476,1286100.0,-0.05705451965332031,0.05705451965332031,0.0,37.09763581564369,26.273325156685537,32.16889935715078,7.419361781964043,-92.58063821803596,-0.2284951778889095,0.18575341642894763,-0.042277570803421316,-2691100.0,-1.0
87,ACGL,2020-07-06,27.100608825683594,27.73771093027378,26.881902593254363,27.385877666791714,1207000.0,0.38986968994140625,0.0,0.38986968994140625,43.11050673173788,26.273325156685537,32.16889935715078,14.032283215649674,-85.96771678435033,-0.2472547208326219,0.09915178871992249,-0.040726957400476715,-1484100.0,1.0
88,ACGL,2020-07-07,26.159217834472656,26.910426702957796,26.083146027364098,26.910426702957796,1327100.0,-0.9413909912109375,0.9413909912109375,0.0,34.043769568403405,26.083146027364098,29.962813040218858,1.9607818623738744,-98.03921813762612,-0.3341567873180935,0.012490073306807806,-0.0693504999429666,-2811200.0,-1.0
89,ACGL,2020-07-08,26.292343139648438,26.682211379217538,25.67425947791901,26.026092720642197,2009300.0,0.13312530517578125,0.0,0.13312530517578125,36.23207855912387,25.67425947791901,29.639507910268005,15.587514181634235,-84.41248581836577,-0.38782302057332174,-0.0675725456211079,-0.02811959476852033,-801900.0,1.0
90,ACGL,2020-07-09,25.712297439575195,26.43497873525586,24.932559111833893,26.140200695147033,1792500.0,-0.5800457000732422,0.5800457000732422,0.0,31.052454349501247,24.932559111833893,29.639507910268005,16.565685354399918,-83.43431464560008,-0.47168090266601936,-0.14839421715275403,-0.0637118288203129,-2594400.0,-1.0
91,ACGL,2020-07-10,26.84386444091797,26.91042704627528,25.588678700765904,25.807384922281344,1826600.0,1.1315670013427734,0.0,1.1315670013427734,47.83770008846569,24.932559111833893,28.859771285389247,48.668247209922136,-51.331752790077864,-0.44180798517216147,-0.20707697082788623,0.019133524233132526,-767800.0,1.0
92,ACGL,2020-07-13,26.900920867919922,27.633111373497428,26.701231229166023,27.366860940085626,2312000.0,0.057056427001953125,0.0,0.057056427001953125,48.566200339858305,24.932559111833893,28.859771285389247,50.1210952986033,-49.8789047013967,-0.4088198423945215,-0.24742554518040524,-0.002819839457998019,1544200.0,1.0
93,ACGL,2020-07-14,27.480966567993164,27.775744598169887,26.815338699410407,26.87239210215865,2015800.0,0.5800457000732422,0.0,0.5800457000732422,55.806218922254985,24.932559111833893,28.260704120750976,76.57140687474059,-23.428593125259408,-0.33207478721194406,-0.26435539359986865,0.00872599163848986,3560000.0,1.0
94,ACGL,2020-07-15,28.850261688232422,28.98338690270958,27.880344747540228,28.175122785466083,2511000.0,1.3692951202392578,0.0,1.3692951202392578,68.05467070163206,24.932559111833893,28.98338690270958,96.71362937775295,-3.2863706222470452,-0.15899892108275537,-0.24328409908334692,0.07779752263657924,6071000.0,1.0
95,ACGL,2020-07-16,29.306692123413086,29.744106386140515,28.526955626480483,28.698117650430564,1900000.0,0.45643043518066406,0.0,0.45643043518066406,71.13192446762709,24.932559111833893,29.744106386140515,90.9090727412532,-9.090927258746802,0.014802423327488157,-0.19166679457550942,0.0971876133594971,7971000.0,1.0
96,ACGL,2020-07-17,29.183076858520508,29.30669287136433,28.907315409853084,29.249639466489878,1735100.0,-0.12361526489257812,0.12361526489257812,0.0,69.05325465020232,24.932559111833893,29.744106386140515,88.3399352508522,-11.660064749147788,0.14094611684127756,-0.12514421226568545,0.0768421125234402,6235900.0,-1.0
97,ACGL,2020-07-20,28.564992904663086,29.04994956218622,28.38432167490847,28.99289615783556,1483300.0,-0.6180839538574219,0.6180839538574219,0.0,59.09084445074373,24.932559111833893,29.744106386140515,75.4940892345831,-24.50591076541689,0.188888097691418,-0.0623377502542743,0.09196662856716209,4752600.0,-1.0
98,ACGL,2020-07-21,28.935842514038086,29.725088220188706,28.688608678971086,29.725088220188706,1929200.0,0.370849609375,0.0,0.370849609375,62.805801018829754,24.932559111833893,29.744106386140515,83.20158098791815,-16.798419012081848,0.2538664793663514,0.000903095685953825,0.10054255569193815,6681800.0,1.0
99,ACGL,2020-07-22,29.230621337890625,29.30669314967733,28.53646582862507,28.63155604678221,1034200.0,0.29477882385253906,0.0,0.29477882385253906,65.66543918675217,24.932559111833893,29.744106386140515,89.32806810416535,-10.671931895834636,0.3253871148469152,0.0657998995313658,0.13683428742933668,7716000.0,1.0
100,ACGL,2020-07-23,29.658525466918945,29.76312307123056,28.945351574026567,29.240129608587484,1807000.0,0.4279041290283203,0.0,0.4279041290283203,69.58247746490997,24.932559111833893,29.76312307123056,97.83467095786725,-2.1653290421327593,0.4118346217523161,0.135006843986834,0.10485304871792622,9523000.0,1.0
101,ACGL,2020-07-24,29.335220336914062,29.668035188825236,29.164058309434317,29.668035188825236,1617400.0,-0.3233051300048828,0.3233051300048828,0.0,63.28797320204785,24.932559111833893,29.76312307123056,91.1417644417249,-8.858235558275098,0.4490888943018767,0.19782325405803192,0.0904913062621997,7905600.0,-1.0
102,ACGL,2020-07-27,28.650571823120117,29.20209289628306,28.365302990471875,29.09749529161604,1502500.0,-0.6846485137939453,0.6846485137939453,0.0,51.83133885333829,24.932559111833893,29.76312307123056,76.96850186723542,-23.031498132764582,0.41856095444406094,0.24197079413984213,0.04256055740372622,6403100.0,-1.0
103,ACGL,2020-07-28,28.622045516967773,29.08798556927694,28.593517908734366,28.783698336233808,1342300.0,-0.02852630615234375,0.02852630615234375,0.0,51.38415015555513,24.932559111833893,29.76312307123056,76.37796406684355,-23.62203593315646,0.38759808678389973,0.2710962526710838,-0.007910367459777135,5060800.0,-1.0
104,ACGL,2020-07-29,29.344728469848633,29.43981686947421,28.469901771950575,28.574499374277703,1514900.0,0.7226829528808594,0.0,0.7226829528808594,61.17571377140492,25.588678700765904,29.76312307123056,89.97723854359675,-10.022761456403247,0.41655559939192344,0.30018812201719364,0.0012978723861216679,6575700.0,1.0
105,ACGL,2020-07-30,29.582454681396484,30.229065990189095,28.479412500642642,28.564993515847256,2464500.0,0.23772621154785156,0.0,0.23772621154785156,63.9328791040718,26.701231229166023,30.229065990189095,81.67115659903827,-18.32884340096172,0.4534546215869639,0.33084142193278454,0.013685254122180357,9040200.0,1.0
106,ACGL,2020-07-31,29.240129470825195,29.668034530022585,28.507937175618547,29.582453518183108,1930900.0,-0.34232521057128906,0.34232521057128906,0.0,57.18522398815157,26.815338699410407,30.229065990189095,71.03059397757812,-28.969406022421868,0.4498949706759028,0.3546521316824254,0.023635103583445893,7109300.0,-1.0
107,ACGL,2020-08-03,29.430309295654297,29.639506312689825,28.926332437806714,29.287673069721713,1296300.0,0.19017982482910156,0.0,0.19017982482910156,59.89831698287531,27.880344747540228,30.229065990189095,65.99184781783778,-34.00815218216223,0.4571464598848607,0.375150997323613,0.017088383770969218,8405600.0,1.0
108,ACGL,2020-08-04,28.8787899017334,29.582454614506307,28.78369968353272,29.53490859855844,1311400.0,-0.5515193939208984,0.5515193939208984,0.0,49.41947316395587,28.365302990471875,30.229065990189095,27.551084088450743,-72.44891591154925,0.4136314274345274,0.38284708334600637,-0.012036399503460471,7094200.0,-1.0
109,ACGL,2020-08-05,29.306692123413086,29.572944362190434,28.983386481217373,29.030932495478503,1403400.0,0.4279022216796875,0.0,0.4279022216796875,56.268444275538506,28.365302990471875,30.229065990189095,50.51013101365588,-49.48986898634412,0.4089526169567499,0.3880681900682693,-0.011862806325226516,8497600.0,1.0
110,ACGL,2020-08-06,29.782140731811523,29.782140731811523,29.068966856763566,29.087985262051635,1699000.0,0.4754486083984375,0.0,0.4754486083984375,62.73724652619156,28.365302990471875,30.229065990189095,76.02027412040148,-23.979725879598522,0.43854698195607256,0.39816394844600655,0.015234942494537052,10196600.0,1.0
111,ACGL,2020-08-07,30.894695281982422,30.942239483691125,29.439818043443534,29.649016883829926,1415500.0,1.1125545501708984,0.0,1.1125545501708984,73.37209990951038,28.365302990471875,30.942239483691125,98.15501073333365,-1.844989266666347,0.5454714882008034,0.4276254563973783,0.07832735321015005,11612100.0,1.0
112,ACGL,2020-08-10,31.122907638549805,31.560320080349115,30.809113018090272,31.056345033379905,1590100.0,0.2282123565673828,0.0,0.2282123565673828,75.05698853373386,28.365302990471875,31.560320080349115,86.30954296973364,-13.690457030266357,0.6412298717859848,0.470346339475578,0.0873753806344646,13202200.0,1.0
113,ACGL,2020-08-11,31.237014770507812,32.02626227919883,31.094382169674834,31.79804503952011,1631400.0,0.11410713195800781,0.0,0.11410713195800781,75.93547117223818,28.365302990471875,32.02626227919883,78.4415109143301,-21.5584890856699,0.7180477266330136,0.519886616907509,0.06448470983820753,14833600.0,1.0
114,ACGL,2020-08-12,30.999290466308594,31.63639436434794,30.866165253181272,31.588850163572467,1243400.0,-0.23772430419921875,0.23772430419921875,0.0,70.00836214560468,28.365302990471875,32.02626227919883,71.94801329660915,-28.051986703390853,0.7510882552345848,0.5661269445732555,0.04789446312591217,13590200.0,-1.0
115,ACGL,2020-08-13,30.771076202392578,31.10388922818888,30.40973375482093,30.87567561832568,694700.0,-0.22821426391601562,0.22821426391601562,0.0,64.43712687464595,28.365302990471875,32.02626227919883,65.71428475942638,-34.28571524057362,0.7502122023176874,0.602943996122353,0.052357727522886366,12895500.0,-1.0
116,ACGL,2020-08-14,30.66647720336914,30.951746033271323,30.352680764998745,30.46678938517661,764700.0,-0.1045989990234375,0.1045989990234375,0.0,61.83476926503631,28.469901771950575,32.02626227919883,61.76470093348808,-38.23529906651192,0.7326331236683892,0.6288818216316793,0.042003225154598534,12130800.0,-1.0
117,ACGL,2020-08-17,30.200536727905273,30.656969388584404,29.93428449365036,30.656969388584404,1479800.0,-0.4659404754638672,0.4659404754638672,0.0,51.205604839686764,28.469901771950575,32.02626227919883,48.6630911693984,-51.3369088306016,0.6733460069415287,0.6377746586936819,0.045768774615190466,10651000.0,-1.0
118,ACGL,2020-08-18,30.029375076293945,30.42875252574211,29.877231458760832,30.24808129978592,875700.0,-0.17116165161132812,0.17116165161132812,0.0,47.728124477190676,28.479412500642642,32.02626227919883,43.6996961366163,-56.3003038633837,0.6055698795565974,0.631333702866246,0.02465931500687879,9775300.0,-1.0
119,ACGL,2020-08-19,29.858213424682617,30.4192437014527,29.668034807247253,30.057903058739004,895000.0,-0.17116165161132812,0.17116165161132812,0.0,44.259912426985515,28.507937175618547,32.02626227919883,38.378382023026084,-61.62161797697392,0.5319151204011447,0.611449986373179,0.0025543057349748377,8880300.0,-1.0
120,ACGL,2020-08-20,29.858213424682617,30.086428853822056,29.411291769329758,29.534907779977992,800500.0,0.0,0.0,0.0,44.259912426985515,28.78369968353272,32.02626227919883,33.137794859721495,-66.8622051402785,0.4681466697702774,0.5827893230525449,-0.03354886163594151,8880300.0,1.0
121,ACGL,2020-08-21,29.38276481628418,29.86772329416389,29.268658006015453,29.839195684749185,1022900.0,-0.4754486083984375,0.4754486083984375,0.0,34.885073033815345,28.78369968353272,32.02626227919883,18.475052218024942,-81.52494778197506,0.37492603198941765,0.541216664839857,-0.055911961776676344,7857400.0,-1.0
122,ACGL,2020-08-24,30.381208419799805,30.419243417453774,29.363745480555032,29.48736330374416,791800.0,0.998443603515625,0.0,0.998443603515625,56.96988338602641,28.983386481217373,32.02626227919883,45.93752855472115,-54.062471445278845,0.37725947317239417,0.5084252265063249,-0.027397187503205633,8649200.0,1.0
123,ACGL,2020-08-25,29.924776077270508,30.599914976491135,29.829687675254792,30.571389181364424,884200.0,-0.4564323425292969,0.4564323425292969,0.0,48.32455054112747,29.068966856763566,32.02626227919883,28.93891540271624,-71.06108459728377,0.338380233003857,0.4744162278057987,-0.034662547847858494,7765000.0,-1.0
124,ACGL,2020-08-26,29.848703384399414,30.03888381019458,29.48736275182255,29.88674019503643,1345100.0,-0.07607269287109375,0.07607269287109375,0.0,46.95426302170937,29.268658006015453,32.02626227919883,21.034395109721682,-78.96560489027831,0.29799498774565336,0.43913197979374247,-0.029975318767740955,6419900.0,-1.0
125,ACGL,2020-08-27,30.723533630371094,31.21800131445845,30.03888550972858,30.076920508822575,980900.0,0.8748302459716797,0.0,0.8748302459716797,61.45657125121093,29.268658006015453,32.02626227919883,52.75868036990426,-47.24131963009574,0.33274120890732917,0.4178538256164467,0.0018605471578485577,7400800.0,1.0
126,ACGL,2020-08-28,30.685495376586914,31.03732680988832,30.03888409909841,31.03732680988832,1269700.0,-0.03803825378417969,0.03803825378417969,0.0,60.62503094380837,29.268658006015453,32.02626227919883,51.37928543082302,-48.62071456917698,0.35313782745597067,0.4049106259843452,0.016057948011021228,6131100.0,-1.0
127,ACGL,2020-08-31,29.99134063720703,30.590404101991567,29.905759624039238,30.533352511473062,1111500.0,-0.6941547393798828,0.6941547393798828,0.0,47.18253586903365,29.268658006015453,31.63639436434794,30.522090377517287,-69.47790962248271,0.30972222144533745,0.38587294507653613,-0.0012665744455314654,5019600.0,-1.0
128,ACGL,2020-09-01,30.04839324951172,30.162500054931545,29.66803420862068,29.73459681406474,930100.0,0.0570526123046875,0.0,0.0570526123046875,48.27030070349709,29.268658006015453,31.21800131445845,39.99989330350766,-60.00010669649234,0.2767285409191338,0.36404406424504876,0.006369430820394983,5949700.0,1.0
129,ACGL,2020-09-02,30.552370071411133,30.6854952821213,29.810668582393838,30.181518420055,1233000.0,0.5039768218994141,0.0,0.5039768218994141,57.245126545370006,29.268658006015453,31.21800131445845,65.85356513835528,-34.14643486164473,0.287926774875487,0.3488206063711326,0.023248432076471204,7182700.0,1.0
130,ACGL,2020-09-03,30.54286003112793,31.427195961839722,30.40973481616315,30.742551480965147,1480200.0,-0.009510040283203125,0.009510040283203125,0.0,57.02969622171233,29.268658006015453,31.427195961839722,59.03079080330112,-40.96920919669888,0.2926604717425221,0.33758857944540827,0.03948216657272541,5702500.0,-1.0
131,ACGL,2020-09-04,30.305137634277344,31.265545388934054,29.934285965880363,31.103890748936486,1141300.0,-0.23772239685058594,0.23772239685058594,0.0,51.4456080231836,29.268658006015453,31.427195961839722,48.01766980586153,-51.98233019413847,0.2740710972744971,0.324885083011224,-0.0025038762274144366,4561200.0,-1.0
132,ACGL,2020-09-08,29.477853775024414,29.953303029460294,28.973876912392196,29.953303029460294,1486300.0,-0.8272838592529297,0.8272838592529297,0.0,36.92693726136519,28.973876912392196,31.427195961839722,20.542654765824718,-79.45734523417528,0.19039148827050312,0.2979863640630764,-0.014934858696755815,3074900.0,-1.0
133,ACGL,2020-09-09,30.0008487701416,30.333663628077662,29.477855288881408,29.696561521866936,1697300.0,0.5229949951171875,0.0,0.5229949951171875,47.694487417891644,28.973876912392196,31.427195961839722,41.86050966264147,-58.13949033735854,0.16437996496851426,0.2712650842441612,0.005097219258834107,4772200.0,1.0
134,ACGL,2020-09-10,29.62999725341797,30.210045921511952,29.53490704023445,30.04839310320846,1266800.0,-0.3708515167236328,0.3708515167236328,0.0,41.84914441928601,28.973876912392196,31.427195961839722,26.744191350632825,-73.25580864936718,0.11254453714342105,0.23952097482401055,-0.03559279313731456,3505400.0,-1.0
135,ACGL,2020-09-11,29.221111297607422,29.81066918233659,28.973877462959383,29.668034766034456,1294600.0,-0.4088859558105469,0.4088859558105469,0.0,36.20429961836935,28.973876912392196,31.427195961839722,10.077547201653267,-89.92245279834673,0.038033363555868505,0.1992234525703795,-0.04772235419398896,2210800.0,-1.0
136,ACGL,2020-09-14,29.515892028808594,29.82968847952811,29.24013057718187,29.53490862150746,1323300.0,0.2947807312011719,0.0,0.2947807312011719,42.64031381892796,28.973876912392196,31.427195961839722,22.09313609407861,-77.90686390592138,0.00273694812573666,0.15992615168144883,-0.0158528628029585,3534100.0,1.0
137,ACGL,2020-09-15,28.802717208862305,29.86772254178615,28.707626993570354,29.563435303807907,1905800.0,-0.7131748199462891,0.7131748199462891,0.0,33.270520767975555,28.707626993570354,31.427195961839722,3.496517882113586,-96.50348211788642,-0.08183827005686695,0.11157326733378363,-0.04145566221480601,1628300.0,-1.0
138,ACGL,2020-09-16,29.107004165649414,29.61097921854655,28.87878873937043,28.99289554566243,1400700.0,0.3042869567871094,0.0,0.3042869567871094,39.78459171484083,28.707626993570354,31.427195961839722,14.6853114129041,-85.3146885870959,-0.12289516019983537,0.06467958182705824,-0.04730781613287005,3029000.0,1.0
139,ACGL,2020-09-17,28.926332473754883,29.068966886169772,28.346283807746715,28.736152048071727,1581900.0,-0.18067169189453125,0.18067169189453125,0.0,37.29063339926514,28.346283807746715,31.427195961839722,18.82717315511804,-81.17282684488197,-0.16807398870237122,0.01812886772117111,-0.05292652867889758,1447100.0,-1.0
140,ACGL,2020-09-18,28.032487869262695,28.983386387056097,27.87083504869002,28.878788783411416,3670200.0,-0.8938446044921875,0.8938446044921875,0.0,27.463114451575535,27.87083504869002,31.427195961839722,4.545456001806865,-95.45454399819313,-0.2728576799609357,-0.04006844181525149,-0.07499222714118658,-2223100.0,-1.0
141,ACGL,2020-09-21,27.471458435058594,27.58556705869372,26.606140902616943,27.338333218896814,2901300.0,-0.5610294342041016,0.5610294342041016,0.0,23.06157477964483,26.606140902616943,31.427195961839722,17.948717071510735,-82.05128292848927,-0.3965973882653273,-0.11137423110526787,-0.06806449870057263,-5124400.0,-1.0
142,ACGL,2020-09-22,27.57605743408203,28.25119452137733,27.3288235980641,27.56654823111653,1448600.0,0.1045989990234375,0.0,0.1045989990234375,25.625861425643464,26.606140902616943,31.427195961839722,20.118345871400447,-79.88165412859955,-0.48068084295732305,-0.18523555347567988,-0.0808240911661422,-3675800.0,1.0
143,ACGL,2020-09-23,26.558595657348633,27.918380815962138,26.539577251874114,27.652128580403804,2045500.0,-1.0174617767333984,1.0174617767333984,0.0,18.64950023835587,26.539577251874114,31.427195961839722,0.3891139346803232,-99.61088606531968,-0.6222442068968626,-0.27263728415991734,-0.1036585177447168,-5721300.0,-1.0
144,ACGL,2020-09-24,26.758283615112305,27.072080052319773,26.06412813487987,26.596630795114823,2230800.0,0.19968795776367188,0.0,0.19968795776367188,23.373513168255172,26.06412813487987,31.265545388934054,13.34550654807368,-86.65449345192631,-0.7101352248348185,-0.3601368722948983,-0.08428247842499981,-3490500.0,1.0
145,ACGL,2020-09-25,27.053064346313477,27.110117751211735,26.406453045149753,26.415962248248636,1647900.0,0.2947807312011719,0.0,0.2947807312011719,30.270545229546798,26.06412813487987,30.333663628077662,23.16261834593427,-76.83738165406572,-0.7473879886363086,-0.4375870955631809,-0.08344073355774939,-1842600.0,1.0
146,ACGL,2020-09-28,27.823291778564453,28.260704240800933,27.461949314052095,27.595076344306932,1800000.0,0.7702274322509766,0.0,0.7702274322509766,45.15379338455143,26.06412813487987,30.333663628077662,41.20269398128383,-58.79730601871618,-0.7066154172968808,-0.49139275990992115,-0.034004619189070495,-42600.0,1.0
147,ACGL,2020-09-29,27.452442169189453,27.87083622887497,27.11011810790579,27.661639199032212,1276600.0,-0.370849609375,0.370849609375,0.0,40.36709856935405,26.06412813487987,30.210045921511952,33.486289544525064,-66.51371045547494,-0.6962016223226897,-0.5323545323924751,-0.05684411858547056,-1319200.0,-1.0
148,ACGL,2020-09-30,27.81378173828125,28.260703390205485,27.5855663108926,27.671147322875218,2362100.0,0.3613395690917969,0.0,0.3613395690917969,46.71737607880337,26.06412813487987,29.86772254178615,46.000004633104176,-53.999995366895824,-0.651284204238582,-0.5561404667616966,-0.03846152070896158,1042900.0,1.0
149,ACGL,2020-10-01,27.956417083740234,28.241687737737667,27.690166649776693,27.908872881588188,1291300.0,0.14263534545898438,0.0,0.14263534545898438,49.182179790310926,26.06412813487987,29.86772254178615,49.75001922982347,-50.24998077017653,-0.5972922301906962,-0.5643708194474966,-0.0027136651544179546,2334200.0,1.0
150,ACGL,2020-10-02,28.241687774658203,28.469903209937467,27.195699002690297,27.44293284433326,701800.0,0.28527069091796875,0.0,0.28527069091796875,54.08380937137063,26.06412813487987,29.86772254178615,57.250048423262065,-42.749951576737935,-0.5254276256406705,-0.5565821806861313,0.028037438981275864,3036000.0,1.0
151,ACGL,2020-10-05,29.135530471801758,29.183076486670505,28.222668750662024,28.545974396989433,990000.0,0.8938426971435547,0.0,0.8938426971435547,65.95571675805755,26.06412813487987,29.61097921854655,86.59518723708916,-13.404812762910831,-0.39183252646856914,-0.5236322498426188,0.056551704007996806,4026000.0,1.0
152,ACGL,2020-10-06,28.698118209838867,29.430310520477853,28.55548379166511,29.430310520477853,936700.0,-0.4374122619628906,0.4374122619628906,0.0,57.5533265838307,26.06412813487987,29.430310520477853,78.24858469429262,-21.75141530570739,-0.31759171464572233,-0.4824241428032395,0.08055857245216358,3089300.0,-1.0
153,ACGL,2020-10-07,28.755170822143555,29.335219495590433,28.631554813450684,28.907314439163233,1288300.0,0.0570526123046875,0.0,0.0570526123046875,58.35183366789354,26.06412813487987,29.430310520477853,79.94346054382423,-20.056539456175773,-0.2512553833213964,-0.43619039090687073,0.07462687950222135,4377600.0,1.0
154,ACGL,2020-10-08,29.953304290771484,29.962813493904022,28.897806321095217,28.897806321095217,1230900.0,1.1981334686279297,0.0,1.1981334686279297,71.39235169209573,26.06412813487987,29.962813493904022,99.75609206035242,-0.24390793964758573,-0.10084215306083877,-0.36912074333766426,0.10720559812859887,5608500.0,1.0
155,ACGL,2020-10-09,29.981830596923828,30.428752242556182,29.93428458332785,30.40973383711779,1772200.0,0.02852630615234375,0.0,0.02852630615234375,71.63632911614184,26.06412813487987,30.428752242556182,89.76036344467035,-10.239636555329652,0.020427750895027685,-0.29121104449112584,0.07758028185659716,7380700.0,1.0
156,ACGL,2020-10-12,30.152992248535156,30.286119279283152,29.515891959098905,29.791651596379292,1616500.0,0.17116165161132812,0.0,0.17116165161132812,73.21766717241287,26.06412813487987,30.428752242556182,93.68193028270106,-6.318069717298941,0.12886083154022998,-0.20719666928485467,0.09837194311173514,8997200.0,1.0
157,ACGL,2020-10-13,29.297183990478516,30.124466531884167,29.230621381777095,29.972322908082333,1128700.0,-0.8558082580566406,0.8558082580566406,0.0,55.398785612645895,26.06412813487987,30.428752242556182,74.0740960925475,-25.925903907452497,0.1440777456278326,-0.1369417863023172,0.05333335344886225,7868500.0,-1.0
158,ACGL,2020-10-14,28.96436882019043,29.668035339786563,28.73615338695454,29.021424038770686,1669200.0,-0.33281517028808594,0.33281517028808594,0.0,49.94462573159506,26.406453045149753,30.428752242556182,63.59337407545455,-36.40662592454545,0.1278086769989244,-0.08399169364206888,0.03605439614922723,6199300.0,-1.0
159,ACGL,2020-10-15,29.373254776000977,29.439817382376525,28.622045886440507,28.698117695683276,810800.0,0.4088859558105469,0.0,0.4088859558105469,56.074992406826404,27.11011810790579,30.428752242556182,68.19482281777954,-31.80517718222047,0.14622329337844064,-0.03794869623796696,0.040067258386665916,7010100.0,1.0
160,ACGL,2020-10-16,29.335220336914062,29.629998376631942,28.99289628195457,29.27816693231916,1015500.0,-0.03803443908691406,0.03803443908691406,0.0,55.34745368460128,27.11011810790579,30.428752242556182,67.04873567639234,-32.95126432360765,0.15595026068342221,0.0008310951463108843,0.00685382630343967,5994600.0,-1.0
161,ACGL,2020-10-19,28.42235565185547,29.525397769369302,28.403339060218645,29.525397769369302,1306400.0,-0.9128646850585938,0.9128646850585938,0.0,40.71744199515229,27.195699002690297,30.428752242556182,37.941121229913804,-62.05887877008619,0.08897303746764251,0.018459483610577216,-0.009609081542108044,4688200.0,-1.0
162,ACGL,2020-10-20,28.774188995361328,29.173566440237,28.526955166276863,28.82173319516047,1287500.0,0.3518333435058594,0.0,0.3518333435058594,46.95314168551687,27.195699002690297,30.428752242556182,48.82350755029665,-51.176492449703346,0.06355045366553114,0.027477677621568008,0.0006613827243595605,5975700.0,1.0
163,ACGL,2020-10-21,29.344728469848633,29.506381288385064,28.612536185083908,28.612536185083908,2238300.0,0.5705394744873047,0.0,0.5705394744873047,55.67658729141201,27.195699002690297,30.428752242556182,66.47058701846439,-33.52941298153561,0.08842123465287344,0.039666389027829096,-0.02031748534369049,8214000.0,1.0
164,ACGL,2020-10-22,30.124465942382812,30.22906536183533,29.15454899935499,29.306692620179547,3087900.0,0.7797374725341797,0.0,0.7797374725341797,64.80374341666783,28.222668750662024,30.428752242556182,86.2069454174598,-13.793054582540194,0.16910034206744484,0.06555317963575226,0.004757392814887629,11301900.0,1.0
165,ACGL,2020-10-23,30.24808120727539,30.580896049746812,29.953303175918407,30.495315038434303,884700.0,0.12361526489257812,0.0,0.12361526489257812,66.08139340414623,28.403339060218645,30.580896049746812,84.71613629071835,-15.283863709281647,0.24024441740830937,0.1004914271902637,0.0031535496695143106,12186600.0,1.0
166,ACGL,2020-10-26,28.983386993408203,29.981831546196407,28.87878938757527,29.95330393713559,1366900.0,-1.2646942138671875,1.2646942138671875,0.0,46.25845990331246,28.403339060218645,30.580896049746812,26.63755465317318,-73.36244534682682,0.19235920429244757,0.11886498261070048,-0.010710824534272523,10819700.0,-1.0
167,ACGL,2020-10-27,27.775745391845703,29.011914578013595,27.72820119047945,28.764680740780015,1440500.0,-1.2076416015625,1.2076416015625,0.0,34.76737418418864,27.72820119047945,30.580896049746812,1.666641674338213,-98.33335832566179,0.05631430684389471,0.10635484745733934,-0.0410374358828135,9379200.0,-1.0
168,ACGL,2020-10-28,28.00396156311035,28.22266778292222,27.14815146176834,27.300295076741374,2236400.0,0.22821617126464844,0.0,0.22821617126464844,38.119204606254506,27.14815146176834,30.580896049746812,24.930782917525324,-75.06921708247468,-0.03271009092032173,0.07854185978180711,-0.04661700663861701,11615600.0,1.0
169,ACGL,2020-10-29,28.935842514038086,29.240129752983627,27.680656746540237,27.94690717377008,3679000.0,0.9318809509277344,0.0,0.9318809509277344,50.18015375981247,27.14815146176834,30.580896049746812,52.07760165234168,-47.92239834765832,-0.027747846253550534,0.05728391857473558,-0.013614277250661,15294600.0,1.0
170,ACGL,2020-10-30,28.72664451599121,30.561879019888814,28.37481306582036,29.33522082535157,3328000.0,-0.209197998046875,0.209197998046875,0.0,47.768514571028575,27.14815146176834,30.580896049746812,45.98341105105168,-54.01658894894832,-0.04023196250269123,0.03778074235925022,0.010705969197731813,11966600.0,-1.0
171,ACGL,2020-11-02,29.829687118530273,30.095937541117138,29.13552982638386,29.335219457018983,2411400.0,1.1030426025390625,0.0,1.1030426025390625,59.58536365477479,27.14815146176834,30.580896049746812,78.11637562994682,-21.883624370053177,0.038437375786916306,0.03791206904478344,0.036682115466020626,14378000.0,1.0
172,ACGL,2020-11-03,30.343172073364258,30.752058733155515,29.98183142848769,30.38120888529601,2120900.0,0.5134849548339844,0.0,0.5134849548339844,63.964452715245045,27.14815146176834,30.752058733155515,88.65435126376399,-11.345648736236019,0.14059656311391677,0.05844896785861011,0.03402463255168686,16498900.0,1.0
173,ACGL,2020-11-04,30.40973472595215,30.961257617615896,29.259148368724034,29.74410683940783,2227300.0,0.06656265258789062,0.0,0.06656265258789062,64.53915768673907,27.14815146176834,30.961257617615896,85.53612542840003,-14.463874571599963,0.2243434042514849,0.09162785513718509,0.009469671067860563,18726200.0,1.0
174,ACGL,2020-11-05,30.343172073364258,31.22750800013232,30.143484251807607,30.523841488955032,2023800.0,-0.06656265258789062,0.06656265258789062,0.0,63.37297699272674,27.14815146176834,31.22750800013232,78.32168092071882,-21.67831907928118,0.2820905703071013,0.12972039817116837,0.003143699113912657,16702400.0,-1.0
175,ACGL,2020-11-06,30.0008487701416,30.742552111777453,29.668035725900605,30.685496892454655,2192400.0,-0.34232330322265625,0.34232330322265625,0.0,57.23585853247524,27.14815146176834,31.22750800013232,69.93008043168815,-30.069919568311843,0.29681155914279955,0.1631386303654946,0.03510499918331855,14510000.0,-1.0
176,ACGL,2020-11-09,32.74894332885742,33.167340994152255,32.29251248003665,32.38760450732636,2331400.0,2.7480945587158203,0.0,2.7480945587158203,77.45723453693965,27.14815146176834,33.167340994152255,93.04893685364438,-6.9510631463556125,0.524183600063914,0.23534762430517855,0.17904822595586323,16841400.0,1.0
177,ACGL,2020-11-10,33.49064636230469,33.73787837648596,32.53023684506187,32.87256088576664,1675300.0,0.7417030334472656,0.0,0.7417030334472656,80.35073494483095,27.14815146176834,33.73787837648596,96.248220641297,-3.751779358702999,0.7555176140696673,0.3393816222580764,0.1959253081686112,18516700.0,1.0
178,ACGL,2020-11-11,33.02470397949219,33.79493305891922,32.587291546558745,33.490645833627276,1292000.0,-0.4659423828125,0.4659423828125,0.0,73.51129563154522,27.14815146176834,33.79493305891922,88.41199957950795,-11.588000420492055,0.8909831639306525,0.4497019305925917,0.1413078421155496,17224700.0,-1.0
179,ACGL,2020-11-12,32.07380676269531,33.680823961566304,31.702956918908928,32.4161308115412,1376700.0,-0.950897216796875,0.950897216796875,0.0,61.23706496089855,27.14815146176834,33.79493305891922,74.10586956909097,-25.894130430909033,0.911108503945357,0.5419832452631449,0.11651768952133779,15848000.0,-1.0
180,ACGL,2020-11-13,32.47318649291992,32.72041851651429,31.379651724298938,32.549256489645096,1456500.0,0.3993797302246094,0.0,0.3993797302246094,64.1388470855465,27.14815146176834,33.79493305891922,80.11448779111593,-19.885512208884073,0.9483525413286031,0.6232571044762366,0.08861974863784283,17304500.0,1.0
181,ACGL,2020-11-16,33.56671905517578,33.794936309792824,33.100780783610034,33.45261224156236,1635100.0,1.0935325622558594,0.0,1.0935325622558594,70.99799001225048,27.14815146176834,33.794936309792824,96.56650155172584,-3.4334984482741637,1.0539582045830045,0.7093973244975903,0.10623632143724371,18939600.0,1.0
182,ACGL,2020-11-17,33.509666442871094,33.5286812217365,32.53974948818145,33.04372455808672,1540000.0,-0.0570526123046875,0.0570526123046875,0.0,70.18980395118896,27.680656746540237,33.794936309792824,95.33436664171802,-4.665633358281979,1.120135560164723,0.7915449716310169,0.10193879508831794,17399600.0,-1.0
183,ACGL,2020-11-18,33.176849365234375,33.78542384834279,33.16734197591895,33.737879646985576,1307000.0,-0.33281707763671875,0.33281707763671875,0.0,65.19458208125658,28.37481306582036,33.794936309792824,88.59644113727852,-11.403558862721482,1.1326693432430197,0.8597698459534175,0.09338764203751682,16092600.0,-1.0
184,ACGL,2020-11-19,33.15782928466797,33.26242869880535,32.31153021012348,32.98666726651404,1856200.0,-0.01902008056640625,0.01902008056640625,0.0,64.89006363196935,29.13552982638386,33.794936309792824,86.32643390540315,-13.673566094596845,1.1280640741967396,0.913428691602082,0.10522970662311248,14236400.0,-1.0
185,ACGL,2020-11-20,32.302024841308594,33.11979817309718,32.08331861052166,32.98666932934896,1942100.0,-0.855804443359375,0.855804443359375,0.0,52.22539270617614,29.259148368724034,33.794936309792824,67.08595093331351,-32.91404906668649,1.0433312633764587,0.9394092059569573,-0.013646806343061924,12294300.0,-1.0
186,ACGL,2020-11-23,32.321041107177734,32.65385412603333,32.08331648588378,32.40662211593915,2365000.0,0.019016265869140625,0.0,0.019016265869140625,52.46326489592506,29.259148368724034,33.794936309792824,67.50520038051452,-32.494799619485484,0.9665723087919673,0.9448418265239594,-0.03492334075831394,14659300.0,1.0
187,ACGL,2020-11-24,32.85354232788086,33.11979637352018,32.18791265486739,32.79649073962163,2963200.0,0.532501220703125,0.0,0.532501220703125,59.05096068537945,29.668035725900605,33.794936309792824,77.18883789964951,-22.811162100350487,0.937897166505028,0.9434528945201732,-0.005182836815664338,17622500.0,1.0
188,ACGL,2020-11-25,31.902645111083984,32.58729321677651,31.674431494113172,32.58729321677651,2389700.0,-0.950897216796875,0.950897216796875,0.0,45.934796193854694,29.668035725900605,33.794936309792824,54.14740044636219,-45.85259955363781,0.8288875847954813,0.9205398325752349,-0.005336493197633296,15232800.0,-1.0
189,ACGL,2020-11-27,31.40817642211914,31.950188279134846,31.08487078570715,31.71246365316691,1413300.0,-0.49446868896484375,0.49446868896484375,0.0,40.5329608399352,31.08487078570715,33.794936309792824,11.929808838148602,-88.0701911618514,0.6945904254609054,0.875349951152369,-0.03279659885034636,13819500.0,-1.0
190,ACGL,2020-11-30,30.618932723999023,31.2845624059666,30.343171285736894,31.094381978634445,11979600.0,-0.7892436981201172,0.7892436981201172,0.0,33.31711603646826,30.343171285736894,33.794936309792824,7.988997986256366,-92.01100201374364,0.5184967058651964,0.8039793020949346,-0.08781872086846765,1839900.0,-1.0
191,ACGL,2020-12-01,31.398670196533203,31.50326961621716,30.599915278589418,31.38915917980372,3028100.0,0.7797374725341797,0.0,0.7797374725341797,44.56666375010451,30.343171285736894,33.794936309792824,30.578527316904836,-69.42147268309516,0.43682400463532645,0.7305482426030131,-0.06299663561070712,4868000.0,1.0
192,ACGL,2020-12-02,31.484251022338867,31.702957249741583,30.90420233656252,31.351125808040695,1669200.0,0.08558082580566406,0.0,0.08558082580566406,45.726206694644766,30.343171285736894,33.794936309792824,33.057862532634665,-66.94213746736533,0.37468432794126727,0.659375459670664,-0.05101745269004243,6537200.0,1.0
193,ACGL,2020-12-03,30.989782333374023,31.474738973469194,30.78058350211458,31.398668979532072,2129300.0,-0.49446868896484375,0.49446868896484375,0.0,40.129983450399756,30.343171285736894,33.794936309792824,18.732765502019653,-81.26723449798034,0.2822847054792881,0.5839573088323888,-0.06538567204387047,4407900.0,-1.0
194,ACGL,2020-12-04,32.49220275878906,32.55876899663177,31.284564753499442,31.52228939865555,1848200.0,1.502420425415039,0.0,1.502420425415039,58.1056760386316,30.343171285736894,33.794936309792824,62.25891560043072,-37.74108439956928,0.3265260875103486,0.5324710645679808,0.005887492143751505,6256100.0,1.0
195,ACGL,2020-12-07,31.61737632751465,32.49220123964001,31.427195894803468,32.283006028308755,2067600.0,-0.8748264312744141,0.8748264312744141,0.0,48.35198703656198,30.343171285736894,33.78542384834279,37.01660522007547,-62.98339477992454,0.2876803380253108,0.4835129192594468,-0.02177110500029089,4188500.0,-1.0
196,ACGL,2020-12-08,31.550813674926758,31.93117453980364,31.33210744720907,31.474740050995365,1407400.0,-0.06656265258789062,0.06656265258789062,0.0,47.649775698165655,30.343171285736894,33.78542384834279,35.0829106007155,-64.9170893992845,0.24865738562049344,0.43654181253165614,-0.03965260853617458,2781100.0,-1.0
197,ACGL,2020-12-09,31.902645111083984,31.96920771831631,30.609422523615905,31.79804569189318,3524200.0,0.35183143615722656,0.0,0.35183143615722656,51.90934898523048,30.343171285736894,33.26242869880535,53.42022318298796,-46.57977681701204,0.24331646410667318,0.39789674284665955,0.0,6305300.0,1.0
198,ACGL,2020-12-10,32.5872917175293,32.66336171055646,31.683937425721282,31.76001104613832,2480400.0,0.6846466064453125,0.0,0.6846466064453125,59.338087545367294,30.343171285736894,33.11979817309718,80.8218216861635,-19.178178313836487,0.29097481654506296,0.3765123575863403,0.037541666843789345,8785700.0,1.0
199,ACGL,2020-12-11,32.09282684326172,32.948637010038105,32.03577162301323,32.36858830004413,1676800.0,-0.4944648742675781,0.4944648742675781,0.0,52.570782515756626,30.343171285736894,33.11979637352018,63.01374878528014,-36.98625121471985,0.28555354521299137,0.3583205951116705,0.048136691521826425,7108900.0,-1.0
200,ACGL,2020-12-14,31.921663284301758,32.61581877422734,31.66492024653914,32.4256383432117,2788200.0,-0.17116355895996094,0.17116355895996094,0.0,50.28041674221204,30.343171285736894,33.11979637352018,56.849302612368525,-43.150697387631475,0.2643978682154362,0.3395360497324237,0.01665653623210761,4320700.0,-1.0
201,ACGL,2020-12-15,33.21488571166992,33.21488571166992,31.988225745942945,32.244968782540916,2083300.0,1.293222427368164,0.0,1.293222427368164,63.966442908167515,30.343171285736894,33.21488571166992,100.0,-0.0,0.34797285210704487,0.341223410207348,0.05496826613734984,6404000.0,1.0
202,ACGL,2020-12-16,33.661808013916016,33.83297003239344,33.119796164534115,33.28144716676843,2333100.0,0.44692230224609375,0.0,0.44692230224609375,67.53040787057992,30.343171285736894,33.83297003239344,95.09536134020883,-4.904638659791171,0.44513824138948266,0.362006376443775,0.08622279601055438,8737100.0,1.0
203,ACGL,2020-12-17,33.804443359375,34.02314959467935,33.58573712407065,33.756899156463646,2645700.0,0.14263534545898438,0.0,0.14263534545898438,68.67147013428371,30.343171285736894,34.02314959467935,94.05686074907317,-5.943139250926837,0.5275704867072051,0.39511919849646104,0.04038632315351354,11382800.0,1.0
204,ACGL,2020-12-18,32.739437103271484,34.384491146248656,32.615819277096875,34.384491146248656,4251800.0,-1.0650062561035156,1.0650062561035156,0.0,52.712100326155266,30.599915278589418,34.384491146248656,56.53267101777938,-43.46732898222063,0.5011842022502648,0.41633219924722187,0.035488737716050656,7131000.0,-1.0
205,ACGL,2020-12-21,32.68238067626953,32.86305371416419,32.02626201217245,32.55876648205627,1810900.0,-0.057056427001953125,0.057056427001953125,0.0,51.96555652190071,30.609422523615905,34.384491146248656,54.911800549149625,-45.088199450850375,0.4702481771060718,0.4271153948189919,0.035864907098799303,5320100.0,-1.0
206,ACGL,2020-12-22,32.88207244873047,32.95814244382391,32.35907536263194,32.63483680304935,2512400.0,0.1996917724609375,0.0,0.1996917724609375,54.564199773677316,30.609422523615905,34.384491146248656,60.20155266818982,-39.79844733181018,0.45658142313983063,0.4330086004831597,0.030700505686476864,7832500.0,1.0
207,ACGL,2020-12-23,33.357521057128906,33.77591509046558,33.138811210445525,33.167340632015915,2034700.0,0.4754486083984375,0.0,0.4754486083984375,60.4432340519827,30.609422523615905,34.384491146248656,72.79598884738853,-27.204011152611475,0.4785981655783118,0.4421265135021901,0.023635880706996293,9867200.0,1.0
208,ACGL,2020-12-24,33.14832305908203,33.36702928386698,32.7584548101367,33.36702928386698,604700.0,-0.209197998046875,0.209197998046875,0.0,56.717380133788794,30.609422523615905,34.384491146248656,67.2544207605817,-32.74557923941831,0.4737054820674942,0.4484423072152509,0.032888851486198245,9262500.0,-1.0
209,ACGL,2020-12-28,33.595245361328125,33.756896363329325,33.14832191068267,33.14832191068267,1587400.0,0.44692230224609375,0.0,0.44692230224609375,62.42664869806093,30.609422523615905,34.384491146248656,79.09320693698788,-20.906793063012124,0.5001257482525432,0.45877899542270945,0.052427784295606905,10849900.0,1.0
210,ACGL,2020-12-29,33.56671905517578,34.137260378023285,33.41457542789449,33.88051732685044,1386900.0,-0.02852630615234375,0.02852630615234375,0.0,61.82602881844235,30.609422523615905,34.384491146248656,78.33755693419536,-21.662443065804638,0.5128503455935629,0.4695932654568802,0.010592640497397277,9463000.0,-1.0
211,ACGL,2020-12-30,33.832969665527344,33.890021252807934,33.309972599523036,33.376535202943614,1065200.0,0.2662506103515625,0.0,0.2662506103515625,65.41006516558916,31.66492024653914,34.384491146248656,79.72027569569075,-20.279724304309255,0.5382146743091596,0.48331754722733605,0.005084743265738156,10528200.0,1.0
212,ACGL,2020-12-31,34.29890823364258,34.3749818539665,33.56671596127922,33.7188595745372,1462000.0,0.4659385681152344,0.0,0.4659385681152344,70.92254924698481,31.66492024653914,34.384491146248656,96.85307293826318,-3.146927061736821,0.5891223969731172,0.5044785171764923,0.014627215393282045,11990200.0,1.0
213,ACGL,2021-01-04,33.18635940551758,34.45105253588131,32.939123761910274,34.37498254142594,2167100.0,-1.112548828125,1.112548828125,0.0,49.283524280720364,31.66492024653914,34.45105253588131,54.60757067417151,-45.39242932582848,0.5335433911479441,0.5102914919707826,0.01365088534773351,9823100.0,-1.0
214,ACGL,2021-01-05,33.31948471069336,33.623771944156225,32.805998643953544,33.31948471069336,1814500.0,0.13312530517578125,0.0,0.13312530517578125,51.33360956821854,31.988225745942945,34.45105253588131,54.05410442135603,-45.94589557864396,0.49453800124459946,0.507140793825546,0.01949380740450235,11637600.0,1.0
215,ACGL,2021-01-06,34.783870697021484,35.33538996972907,33.918549534304745,33.95658634687496,3357300.0,1.464385986328125,0.0,1.464385986328125,67.83572154894651,32.02626201217245,35.33538996972907,83.3333953905241,-16.666604609475897,0.5751595712784834,0.5207445493161335,0.05783693382636668,14994900.0,1.0
216,ACGL,2021-01-07,34.46056365966797,35.14520812145902,34.15627279872867,35.0311013157255,2516900.0,-0.3233070373535156,0.3233070373535156,0.0,62.441929383378195,32.02626201217245,35.33538996972907,73.56323716454128,-26.436762835458726,0.6059792204617978,0.5377914835452663,0.03306728340664056,12478000.0,-1.0
217,ACGL,2021-01-08,34.65074157714844,34.717304184921296,33.93756767039057,34.641234187776625,4449800.0,0.19017791748046875,0.0,0.19017791748046875,64.36504254510709,32.02626201217245,35.33538996972907,79.3103076894566,-20.68969231054341,0.6383908103564124,0.5579113489074955,0.04532411836908201,16927800.0,1.0
218,ACGL,2021-01-11,34.39399719238281,34.783869061814194,34.05167677751391,34.403508208773296,1763900.0,-0.256744384765625,0.256744384765625,0.0,59.61045573299467,32.02626201217245,35.33538996972907,71.55163567499636,-28.448364325003645,0.6360283644934981,0.5735347520246961,0.023775740360394648,15163900.0,-1.0
219,ACGL,2021-01-12,34.58417892456055,34.7363225460428,34.146766466222815,34.536634722982974,2256600.0,0.19018173217773438,0.0,0.19018173217773438,62.009059530284304,32.35907536263194,35.33538996972907,74.76036157678915,-25.23963842321086,0.6421004505183774,0.5872478917234324,0.030311567469918588,17420500.0,1.0
220,ACGL,2021-01-13,33.86149597167969,34.93601228620216,33.8234591613237,34.46056303892193,1333700.0,-0.7226829528808594,0.7226829528808594,0.0,49.198494255062,32.7584548101367,35.33538996972907,42.80438168717725,-57.19561831282275,0.5818904788052492,0.5861764091397957,0.0008431511166284711,16086800.0,-1.0
221,ACGL,2021-01-14,33.49064636230469,34.02314720127663,33.319484341952304,33.93756619110044,2005200.0,-0.370849609375,0.370849609375,0.0,43.836273390857905,32.7584548101367,35.33538996972907,28.41327029290911,-71.5867297070909,0.4985027499218191,0.5686416772962004,-0.0235652361244868,14081600.0,-1.0
222,ACGL,2021-01-15,32.98666763305664,33.36702848371185,32.606310409791334,33.25292167947124,1968000.0,-0.5039787292480469,0.5039787292480469,0.0,37.437936813202114,32.606310409791334,35.33538996972907,13.937198052004918,-86.06280194799508,0.3872861106020835,0.532370563957377,-0.00601728469281082,12113600.0,-1.0
223,ACGL,2021-01-19,32.501712799072266,33.66181019333139,32.48269439274456,33.35752294686836,2961800.0,-0.484954833984375,0.484954833984375,0.0,32.21692647261847,32.48269439274456,35.33538996972907,0.6666819439530507,-99.33331805604695,0.2570511955264365,0.47730669027118894,-0.024543354098109482,9151800.0,-1.0
224,ACGL,2021-01-20,32.891578674316406,32.996178087835936,31.864606571459003,32.30202263048522,2885800.0,0.3898658752441406,0.0,0.3898658752441406,39.98105697666702,31.864606571459003,35.33538996972907,29.589057714442042,-70.41094228555797,0.18318634590092842,0.4184826213971368,-0.054401421831041796,12037600.0,1.0
225,ACGL,2021-01-21,32.68238067626953,33.50015397283077,32.482692860334325,32.85354269775397,2409500.0,-0.209197998046875,0.209197998046875,0.0,37.33341365136004,31.864606571459003,35.33538996972907,23.56165772886112,-76.43834227113888,0.10653927233914828,0.3560939515855391,-0.051600519392536515,9628100.0,-1.0
226,ACGL,2021-01-22,31.67443084716797,32.263986910922696,31.33210680131362,32.13086169917711,4254800.0,-1.0079498291015625,1.0079498291015625,0.0,27.287350983632166,31.33210680131362,35.33538996972907,8.551082485375213,-91.44891751462478,-0.03513222866019561,0.2778487155363922,-0.08589457525328392,5373300.0,-1.0
227,ACGL,2021-01-25,31.731483459472656,31.788538678084315,31.113401581101723,31.370144623769065,2443200.0,0.0570526123046875,0.0,0.0570526123046875,28.543168287110078,31.113401581101723,35.33538996972907,14.639592094470066,-85.36040790552994,-0.1411768461512608,0.19404360319886155,-0.07741216346612423,7816500.0,1.0
228,ACGL,2021-01-26,31.284563064575195,32.17840637624677,31.198982051843554,31.864608120434077,2696000.0,-0.44692039489746094,0.44692039489746094,0.0,24.68906242242089,31.113401581101723,35.33538996972907,4.054049128475231,-95.94595087152477,-0.25830315160740724,0.10357425223760779,-0.09540824627304001,5120500.0,-1.0
229,ACGL,2021-01-27,30.029375076293945,31.313088436212688,29.99134007875816,31.09438221272071,3579000.0,-1.25518798828125,1.25518798828125,0.0,17.17415846107609,29.99134007875816,35.14520812145902,0.7379893551922052,-99.2620106448078,-0.44725410426961076,-0.006591419063835948,-0.113170454683714,1541500.0,-1.0
230,ACGL,2021-01-28,30.381208419799805,30.65696986099479,29.79165053975587,30.25759059661068,7977900.0,0.3518333435058594,0.0,0.3518333435058594,24.597208513088916,29.79165053975587,34.93601228620216,11.460272607213113,-88.53972739278689,-0.5621292099781385,-0.1176989772466965,-0.09284496658758734,9519400.0,1.0
231,ACGL,2021-01-29,29.86772346496582,30.314645132848362,29.69656143488887,30.12446651008124,2789600.0,-0.5134849548339844,0.5134849548339844,0.0,21.37172553439575,29.69656143488887,34.93601228620216,3.2667933135406217,-96.73320668645938,-0.6866868046148547,-0.23149654272032819,-0.09455165956094513,6729800.0,-1.0
232,ACGL,2021-02-01,30.447771072387695,30.571388895765296,29.74410638461402,29.953303406267278,6979000.0,0.580047607421875,0.0,0.580047607421875,32.84914607346333,29.69656143488887,34.93601228620216,14.337564352007067,-85.66243564799294,-0.7301775696608495,-0.3312327481084325,-0.06319487650949884,13708800.0,1.0
233,ACGL,2021-02-02,31.522287368774414,31.731482576415292,30.67598463950866,30.733039856532525,2809700.0,1.0745162963867188,0.0,1.0745162963867188,48.81817733192962,29.69656143488887,34.93601228620216,34.84574978745948,-65.15425021254052,-0.6702140204387348,-0.39902900257449303,-0.04163045255748732,16518500.0,1.0
234,ACGL,2021-02-03,31.094383239746094,31.81706454005053,31.027820631588714,31.474740482446816,1893400.0,-0.4279041290283203,0.4279041290283203,0.0,44.00920845738737,29.69656143488887,34.02314720127663,32.30773363414119,-67.69226636585881,-0.6497310669816727,-0.44916941545592903,-0.04858879321714993,14625100.0,-1.0
235,ACGL,2021-02-04,31.75050163269043,32.06429989166677,31.18947134965793,31.18947134965793,1482100.0,0.6561183929443359,0.0,0.6561183929443359,52.31915110468346,29.69656143488887,33.66181019333139,51.798520671079174,-48.20147932892083,-0.5739388981654443,-0.47412331199783214,0.0024016464854415,16107200.0,1.0
236,ACGL,2021-02-05,32.1403694152832,32.48269346462045,31.883626378280262,32.08331782532033,1553800.0,0.38986778259277344,0.0,0.38986778259277344,56.72290060046121,29.69656143488887,33.66181019333139,61.63063477899473,-38.369365221005275,-0.4769163915859771,-0.47468192791546115,0.012885812802694074,17661000.0,1.0
237,ACGL,2021-02-08,32.47318649291992,32.47318649291992,31.56983215719694,32.2259508419355,5159700.0,0.33281707763671875,0.0,0.33281707763671875,60.33166676446842,29.69656143488887,33.50015397283077,73.00006586755646,-26.999934132443542,-0.3689171524032595,-0.4535289728130209,0.03799392773654087,22820700.0,1.0
238,ACGL,2021-02-09,33.37653732299805,33.42408515193852,32.48269400072409,32.615819216021265,3030000.0,0.903350830078125,0.0,0.903350830078125,68.54604370773112,29.69656143488887,33.50015397283077,96.75000283022916,-3.249997169770834,-0.20803600600909888,-0.40443037945223653,0.11146293381730898,25850700.0,1.0
239,ACGL,2021-02-10,33.176849365234375,34.251365727379564,32.549256476105064,34.1562736972751,3619500.0,-0.19968795776367188,0.19968795776367188,0.0,65.10727077335622,29.69656143488887,34.251365727379564,76.40916506738397,-23.59083493261604,-0.09554826666284555,-0.34265395689435835,0.092018754053661,22231200.0,-1.0
240,ACGL,2021-02-11,33.8139533996582,34.17529223325916,33.05323166548974,33.16734210204904,3204500.0,0.6371040344238281,0.0,0.6371040344238281,70.54678588348847,29.69656143488887,34.251365727379564,90.39668228023532,-9.603317719764686,0.04449513562218499,-0.2652241383910497,0.13212355937744036,25435700.0,1.0
241,ACGL,2021-02-12,33.4240837097168,34.317926993422155,33.072248653167,33.79493354415423,2570200.0,-0.38986968994140625,0.38986968994140625,0.0,63.55146214165668,29.69656143488887,34.317926993422155,80.65845966123824,-19.341540338761767,0.1226079670927831,-0.1876577172942831,0.0977514127471959,22865500.0,-1.0
242,ACGL,2021-02-16,33.195865631103516,33.74738848798238,32.72041639340373,33.60475226571651,1970500.0,-0.22821807861328125,0.22821807861328125,0.0,59.562310021221066,29.69656143488887,34.317926993422155,75.72013405763217,-24.279865942367824,0.16420480648638858,-0.11728521253814876,0.053091904237473786,20895000.0,-1.0
243,ACGL,2021-02-17,33.614261627197266,33.87100466590985,33.13881236159396,33.157830767504905,2272700.0,0.41839599609375,0.0,0.41839599609375,64.30233126288621,29.69656143488887,34.317926993422155,84.77364845276995,-15.226351547230053,0.2282999615296717,-0.048168177724584656,0.0810396645600664,23167700.0,1.0
244,ACGL,2021-02-18,33.20537567138672,33.81395379124726,33.186360892463355,33.4240855302965,2129700.0,-0.4088859558105469,0.4088859558105469,0.0,56.79528925518556,29.69656143488887,34.317926993422155,75.92591826065076,-24.074081739349236,0.24329757148591113,0.010124972117514517,0.0458220804044982,21038000.0,-1.0
245,ACGL,2021-02-19,33.36703109741211,33.57622994439839,33.02470703048554,33.27194269099481,3886800.0,0.16165542602539062,0.0,0.16165542602539062,58.97990370780614,29.74410638461402,34.317926993422155,79.21003079616115,-20.78996920383885,0.2651708032646951,0.06113413834695065,0.038165761764568096,24924800.0,1.0
246,ACGL,2021-02-22,33.43359375,33.92806144425866,33.11028808942281,33.386049546730746,3548200.0,0.06656265258789062,0.0,0.06656265258789062,59.942222120726306,30.67598463950866,34.317926993422155,75.71808783651164,-24.28191216348835,0.28459590237485344,0.10582649115253123,0.029575393141337614,28473000.0,1.0
247,ACGL,2021-02-23,33.4240837097168,33.775915138876684,33.19586647377612,33.72837093937777,5447300.0,-0.009510040283203125,0.009510040283203125,0.0,59.711293245595755,31.027820631588714,34.317926993422155,72.83238943049682,-27.16761056950317,0.29581310328060084,0.14382381357814517,0.0014245452204530995,23025700.0,-1.0
248,ACGL,2021-02-24,33.82345962524414,34.489089306044164,33.48113558212471,33.48113558212471,8969300.0,0.39937591552734375,0.0,0.39937591552734375,66.04916297801293,31.18947134965793,34.489089306044164,79.82706817582525,-20.172931824174754,0.3330894663013382,0.1816769441227838,0.019489803051863763,31995000.0,1.0
249,ACGL,2021-02-25,33.74739074707031,34.54614566497109,33.63328031066302,34.2228400165972,4313000.0,-0.07606887817382812,0.07606887817382812,0.0,63.84197489911782,31.56983215719694,34.54614566497109,73.16294416517525,-26.837055834824753,0.35243053007315694,0.21582766131285847,-0.001968496608520276,27682000.0,-1.0
250,ACGL,2021-02-26,34.06118392944336,34.50810738454727,33.62377149066373,33.709352500632775,4665000.0,0.3137931823730469,0.0,0.3137931823730469,68.80396428827574,31.56983215719694,34.54614566497109,83.70595925929813,-16.294040740701874,0.3885994175061569,0.25038201255151815,0.019061112497793076,32347000.0,1.0
251,ACGL,2021-03-01,34.146766662597656,34.974047382453165,34.05167825889568,34.62221593588773,5809900.0,0.08558273315429688,0.0,0.08558273315429688,70.09541964145828,32.48269400072409,34.974047382453165,66.79392309727857,-33.20607690272144,0.4193354941233096,0.2841727088658765,0.028645164493110054,38156900.0,1.0
252,ACGL,2021-03-02,34.58417892456055,34.840921965947494,33.87100501872683,34.08971124789569,5289300.0,0.4374122619628906,0.0,0.4374122619628906,75.96358550667128,32.549256476105064,34.974047382453165,83.92156383991944,-16.078436160080553,0.473530999499836,0.3220443669926684,0.028854338914840794,43446200.0,1.0
253,ACGL,2021-03-03,34.43203353881836,35.21177001238584,34.1943089157212,34.955026984154124,5345400.0,-0.1521453857421875,0.1521453857421875,0.0,70.41780246813055,32.72041639340373,35.21177001238584,68.70229630886129,-31.297703691138718,0.49845854705271364,0.3573272030046775,0.03694154463334853,38100800.0,-1.0
254,ACGL,2021-03-04,33.947078704833984,34.66976000134007,33.66180986746027,34.584178987388945,4797200.0,-0.484954833984375,0.484954833984375,0.0,55.5125588113679,32.72041639340373,35.21177001238584,49.23678044273095,-50.76321955726905,0.473622382021162,0.3805862388079745,0.017383854312014613,33303600.0,-1.0
255,ACGL,2021-03-05,34.58417892456055,34.69828936121479,33.36702995270249,34.308421104454624,4405500.0,0.6371002197265625,0.0,0.6371002197265625,66.31924987522122,32.72041639340373,35.21177001238584,74.80923289879223,-25.19076710120776,0.49958925151980793,0.40438684135034125,0.03441404424436256,37709100.0,1.0
256,ACGL,2021-03-08,35.3924446105957,35.77280184791591,34.61270810259074,34.8123959242381,2796400.0,0.8082656860351562,0.0,0.8082656860351562,75.15417727666953,33.02470703048554,35.77280184791591,86.15923894227709,-13.840761057722917,0.5787173747676704,0.4392529480338071,0.05889049698336768,40505500.0,1.0
257,ACGL,2021-03-09,34.936012268066406,35.50654991355054,34.55565141948372,34.945519656955526,2096500.0,-0.4564323425292969,0.4564323425292969,0.0,64.1839020833208,33.02470703048554,35.77280184791591,69.55019257188701,-30.449807428112997,0.5977067161638558,0.4709437016598169,0.03289292861076554,38409000.0,-1.0
258,ACGL,2021-03-10,35.27833557128906,35.6586964510564,34.869448895125736,34.99306672515865,1533700.0,0.34232330322265625,0.0,0.34232330322265625,68.2007815788338,33.02470703048554,35.77280184791591,82.00694264657142,-17.993057353428583,0.6330807745370066,0.503371116235255,0.0453648353347631,39942700.0,1.0
259,ACGL,2021-03-11,35.173736572265625,35.30686177984405,34.91699354591159,35.192751349871244,1525700.0,-0.1045989990234375,0.1045989990234375,0.0,65.60661915739125,33.11028808942281,35.77280184791591,77.50001201911778,-22.499987980882217,0.6452368172331262,0.5317442564348293,0.03266335794806441,38417000.0,-1.0
260,ACGL,2021-03-12,35.77280044555664,35.82034464493409,35.173737004098946,35.27833279177337,1811000.0,0.5990638732910156,0.0,0.5990638732910156,72.51526429518329,33.19586647377612,35.82034464493409,98.18843227960738,-1.811567720392613,0.6951962271886885,0.5644346505856012,0.047618967822802505,40228000.0,1.0
261,ACGL,2021-03-15,36.2197265625,36.2197265625,35.43999002774316,35.75378466861351,1301400.0,0.4469261169433594,0.0,0.4469261169433594,76.567121793779,33.36702995270249,36.2197265625,100.0,-0.0,0.7620679767102772,0.6039613158105364,0.047291787424160514,41529400.0,1.0
262,ACGL,2021-03-16,36.00101852416992,36.05807011380323,35.67771288248458,35.93445591800441,1609800.0,-0.21870803833007812,0.21870803833007812,0.0,70.68333974071112,33.36702995270249,36.2197265625,92.33328782391611,-7.666712176083888,0.7883290426546026,0.6408348611793496,0.04556759575593183,39919600.0,-1.0
263,ACGL,2021-03-17,35.7537841796875,36.18168925446844,35.41146374725287,36.06758244365689,1550000.0,-0.24723434448242188,0.24723434448242188,0.0,64.244034344652,33.36702995270249,36.2197265625,83.66659878193029,-16.333401218069703,0.7801977472909485,0.6687074384016695,0.05322123563451853,38369600.0,-1.0
264,ACGL,2021-03-18,35.78231430053711,36.49548822994585,34.85994152440361,35.05012196439065,1910400.0,0.028530120849609375,0.0,0.028530120849609375,64.67256001812689,33.36702995270249,36.49548822994585,77.20366179736453,-22.796338202635464,0.767211838937591,0.6884083185088539,0.0346440312661489,40280000.0,1.0
265,ACGL,2021-03-19,35.09766387939453,35.8203451513628,34.89797606275211,35.59213154016859,2757600.0,-0.6846504211425781,0.6846504211425781,0.0,48.55844997680034,33.36702995270249,36.49548822994585,55.31906687970889,-44.680933120291115,0.6936785514089152,0.6894623650888662,-0.008328916932539898,37522400.0,-1.0
266,ACGL,2021-03-22,34.83141326904297,35.08815630079197,34.43203401052565,34.70779544766976,1448000.0,-0.2662506103515625,0.2662506103515625,0.0,43.675383479298134,33.36702995270249,36.49548822994585,46.808465594459555,-53.191534405540445,0.6069224677683778,0.6729543856247685,-0.002994016552915202,36074400.0,-1.0
267,ACGL,2021-03-23,34.96453857421875,35.11668219040216,34.64123293640526,34.64123293640526,1625200.0,0.13312530517578125,0.0,0.13312530517578125,46.763913697175035,33.36702995270249,36.49548822994585,51.06376623708422,-48.93623376291578,0.5426543642606774,0.6468943813519503,-0.008894892346499872,37699600.0,1.0
268,ACGL,2021-03-24,35.42097091674805,35.934457003296004,35.07864685904941,35.07864685904941,1885200.0,0.4564323425292969,0.0,0.4564323425292969,56.253739617851394,33.36702995270249,36.49548822994585,65.65345553706369,-34.34654446293631,0.5225283233972178,0.6220211697610039,0.007028947407235808,39584800.0,1.0
269,ACGL,2021-03-25,36.333831787109375,36.37186859870123,35.012083417107604,35.382933261653136,1547100.0,0.9128608703613281,0.0,0.9128608703613281,69.00430810390313,34.43203401052565,36.49548822994585,92.16573639894483,-7.834263601055172,0.5736261291419638,0.6123421616371959,0.01568318204236152,41131900.0,1.0
270,ACGL,2021-03-26,36.8758430480957,36.90437247001395,36.28628698770781,36.43843060417533,1274300.0,0.5420112609863281,0.0,0.5420112609863281,74.16342314453844,34.43203401052565,36.90437247001395,98.84605516656667,-1.153944833433325,0.6503603381393006,0.6199457969376169,0.018114893398312182,42406200.0,1.0
271,ACGL,2021-03-29,36.942405700683594,37.18013032842902,36.53351905077026,36.91387990611893,1575500.0,0.06656265258789062,0.0,0.06656265258789062,74.75874930186927,34.43203401052565,37.18013032842902,91.34947977635667,-8.650520223643325,0.7083780600545282,0.6376322495609992,0.026148903978415294,43981700.0,1.0
272,ACGL,2021-03-30,37.237186431884766,37.303749039047716,36.62861195074349,37.218168025925344,1961300.0,0.2947807312011719,0.0,0.2947807312011719,77.41766854864055,34.43203401052565,37.303749039047716,97.68213048642201,-2.3178695135779854,0.7692761277294053,0.6639610251946805,0.04148937759265259,45943000.0,1.0
273,ACGL,2021-03-31,36.48597717285156,37.408349947973086,36.39088876665746,37.08504428856689,2725300.0,-0.7512092590332031,0.7512092590332031,0.0,59.10897186375551,34.43203401052565,37.408349947973086,69.00958115647585,-30.99041884352416,0.7482960845950757,0.6808280370747596,0.01966510232972518,43217700.0,-1.0
274,ACGL,2021-04-01,37.474910736083984,37.51294754766868,36.276780190286146,36.44794221502727,2432400.0,0.9889335632324219,0.0,0.9889335632324219,69.91601337521588,34.43203401052565,37.51294754766868,98.76540476952273,-1.2345952304772654,0.8022204252030392,0.7051065147004155,0.06773233867810524,45650100.0,1.0
275,ACGL,2021-04-05,37.674598693847656,38.007415355348066,37.47491087338142,37.56049188606552,1489300.0,0.19968795776367188,0.0,0.19968795776367188,71.66101466165131,34.43203401052565,38.007415355348066,90.69143597836444,-9.308564021635563,0.8512562507878627,0.734336461917905,0.08162704748278538,47139400.0,1.0
276,ACGL,2021-04-06,37.96937942504883,38.04544942287281,37.284731307682506,37.741162176796685,1806900.0,0.2947807312011719,0.0,0.2947807312011719,74.20914280436293,34.43203401052565,38.04544942287281,97.89478957874468,-2.1052104212553258,0.9034889787129572,0.7681669652769155,0.0859396684000775,48946300.0,1.0
277,ACGL,2021-04-07,38.29268264770508,38.31170105280186,37.68410819416773,37.969377015839626,1231000.0,0.32330322265625,0.0,0.32330322265625,76.8440123933081,34.43203401052565,38.31170105280186,99.50979285362534,-0.4902071463746526,0.9599064559045871,0.8065148634024498,0.08107377230586321,50177300.0,1.0
278,ACGL,2021-04-08,38.092994689941406,38.22611989772107,37.69361543921256,37.997902664820316,1372600.0,-0.19968795776367188,0.19968795776367188,0.0,71.62881374429531,34.43203401052565,38.31170105280186,94.36275431687208,-5.637245683127911,0.9772395544481398,0.8406598016115878,0.048416663376972924,48804700.0,-1.0
279,ACGL,2021-04-09,38.092994689941406,38.58746233840148,37.78870746433365,38.53991451214601,1403800.0,0.0,0.0,0.0,71.62881374429531,34.43203401052565,38.58746233840148,88.10068157972935,-11.899318420270646,0.979682984309683,0.8684644381512068,0.03300674754088262,48804700.0,1.0
280,ACGL,2021-04-12,38.03594207763672,38.38777352618563,37.79821743965149,38.29268512194758,1375600.0,-0.0570526123046875,0.0570526123046875,0.0,69.82621608484783,34.64123293640526,38.58746233840148,86.02412063308404,-13.975879366915963,0.9658816684421936,0.8879478842094041,0.029601114389063543,47429100.0,-1.0
281,ACGL,2021-04-13,37.893306732177734,37.95036195249211,37.522456868609794,37.67460049539126,1382400.0,-0.14263534545898438,0.14263534545898438,0.0,65.10022331489759,35.012083417107604,38.58746233840148,80.5851177873885,-19.41488221261149,0.9326831550262611,0.8968949383727756,0.017620028878743588,46046700.0,-1.0
282,ACGL,2021-04-14,38.140541076660156,38.47335411520044,37.76018020913691,37.97888643837625,1064200.0,0.24723434448242188,0.0,0.24723434448242188,69.26116388811086,35.012083417107604,38.58746233840148,87.50003086163551,-12.499969138364483,0.9157664536975716,0.9006692414377347,0.04534794000363851,47110900.0,1.0
283,ACGL,2021-04-15,38.33072280883789,38.46384802876349,38.04545033483709,38.092998165430686,1532400.0,0.19018173217773438,0.0,0.19018173217773438,72.20273184940342,36.276780190286146,38.58746233840148,88.88901574918064,-11.110984250819355,0.9072477352333124,0.9019849401968503,0.02283693425665345,48643300.0,1.0
284,ACGL,2021-04-16,38.11201477050781,38.67304142013263,37.9123233226693,38.64451562503713,1403700.0,-0.21870803833007812,0.21870803833007812,0.0,64.06744741657528,36.276780190286146,38.67304142013263,76.58741698789004,-23.412583012109963,0.8727877250045211,0.8961454971583844,0.011610371226902672,47239600.0,-1.0
285,ACGL,2021-04-19,37.75067138671875,38.4923710601043,37.67459776514591,38.4923710601043,1165000.0,-0.3613433837890625,0.3613433837890625,0.0,52.73934616879365,36.276780190286146,38.67304142013263,61.50795155697738,-38.49204844302262,0.8070177294018066,0.8783199436070688,-0.005760116221067202,46074600.0,-1.0
286,ACGL,2021-04-20,37.31325912475586,37.73165316325404,37.123078697296705,37.655579541314395,1221600.0,-0.4374122619628906,0.4374122619628906,0.0,42.29410844855712,36.276780190286146,38.67304142013263,43.25400426130152,-56.745995738698475,0.7113984614802149,0.844935647181698,-0.025577302378106292,44853000.0,-1.0
287,ACGL,2021-04-21,37.93134307861328,37.93134307861328,37.29424278287093,37.42736800124156,1081600.0,0.6180839538574219,0.0,0.6180839538574219,56.37973841085017,36.276780190286146,38.67304142013263,69.04768427243371,-30.952315727566294,0.6776818181178825,0.8114848813689348,-0.004243604700651438,45934600.0,1.0
288,ACGL,2021-04-22,37.69361877441406,37.902817620800896,37.48441992802723,37.85527341772848,1043600.0,-0.23772430419921875,0.23772430419921875,0.0,50.86930284787893,37.123078697296705,38.67304142013263,36.80992250403652,-63.19007749596347,0.6245790126665938,0.7741037076284667,-0.010484235192797842,44891000.0,-1.0
289,ACGL,2021-04-23,38.026432037353516,38.18808303876756,37.65557858094099,37.81723320974489,749000.0,0.3328132629394531,0.0,0.3328132629394531,57.56854588841638,37.123078697296705,38.67304142013263,58.28226232460424,-41.71773767539576,0.602405747170117,0.7397641155367969,-0.00025002773071303164,45640000.0,1.0
290,ACGL,2021-04-26,38.1785774230957,38.444827850679566,37.97888597501778,37.97888597501778,1077900.0,0.1521453857421875,0.0,0.1521453857421875,60.41564415226598,37.123078697296705,38.67304142013263,68.09832973710378,-31.90167026289622,0.590305461699387,0.709872384769315,0.007528260675010667,46717900.0,1.0
291,ACGL,2021-04-27,38.50188446044922,38.577954459342216,37.921835755905704,37.921835755905704,1389200.0,0.3233070373535156,0.0,0.3233070373535156,66.00800818507001,37.123078697296705,38.67304142013263,88.95734993095529,-11.04265006904471,0.5998889280615884,0.6878756934277698,0.009473997315947447,48107100.0,1.0
292,ACGL,2021-04-28,37.55098342895508,39.25308899021667,37.39883981377555,38.84420234428608,1912200.0,-0.9509010314941406,0.9509010314941406,0.0,44.616699342675076,37.123078697296705,39.25308899021667,20.089326942724394,-79.9106730572756,0.524705647889057,0.6552416843200273,-0.020342412632590068,46194900.0,-1.0
293,ACGL,2021-04-29,38.1690673828125,38.25464839778074,37.484419263066584,37.579511294914695,2282200.0,0.6180839538574219,0.0,0.6180839538574219,55.44574075987448,37.123078697296705,39.25308899021667,49.10721272064289,-50.89278727935711,0.5091276594748066,0.6260188793509832,0.001496971824980431,48477100.0,1.0
294,ACGL,2021-04-30,37.76018142700195,38.273667526502585,37.70312983420645,38.11201651039508,1756200.0,-0.4088859558105469,0.4088859558105469,0.0,48.24515946477313,37.123078697296705,39.25308899021667,29.91078173767246,-70.08921826232753,0.4585029751070522,0.592515698502197,0.0002519171165402678,46720900.0,-1.0
295,ACGL,2021-05-03,38.1690673828125,38.45433622357659,38.01692375924564,38.159559993322745,1349000.0,0.4088859558105469,0.0,0.4088859558105469,54.98979201846865,37.123078697296705,39.25308899021667,49.10721272064289,-50.89278727935711,0.4462323388100842,0.5632590265637745,0.02293576809238962,48069900.0,1.0
296,ACGL,2021-05-04,38.283172607421875,38.47335303584807,37.89330436147365,38.15955841222632,1611700.0,0.114105224609375,0.0,0.114105224609375,56.802457254119155,37.123078697296705,39.25308899021667,54.46423963213973,-45.53576036786027,0.44063573468409345,0.5387343681878383,0.009275430297298604,49681600.0,1.0
297,ACGL,2021-05-05,38.216609954833984,38.3307203881841,37.256204052171924,38.22612097130814,1692500.0,-0.06656265258789062,0.06656265258789062,0.0,55.30335565610106,37.123078697296705,39.25308899021667,51.339247569465606,-48.660752430534394,0.42591959979611005,0.5161714145094927,0.013874793597024482,47989100.0,-1.0
298,ACGL,2021-05-06,37.81723403930664,38.62549631888667,37.34178478605016,38.49237110835725,1769900.0,-0.39937591552734375,0.39937591552734375,0.0,46.7598483575624,37.123078697296705,39.25308899021667,32.58929519342088,-67.41070480657912,0.3776770324823886,0.4884725381040719,-0.005501383822741457,46219200.0,-1.0
299,ACGL,2021-05-07,38.78715133666992,38.86322133170411,37.39884037393877,37.47491036897296,2052700.0,0.9699172973632812,0.0,0.9699172973632812,62.844419914501074,37.123078697296705,39.25308899021667,78.12509849856139,-21.87490150143861,0.4129484575040294,0.47336772198406346,0.015940193549644155,48271900.0,1.0
300,ACGL,2021-05-10,37.959869384765625,39.09144101090047,37.93134358827154,38.98684158723521,1735500.0,-0.8272819519042969,0.8272819519042969,0.0,48.44139769082849,37.256204052171924,39.25308899021667,35.238151141682565,-64.76184885831744,0.36988279767341226,0.45267073712193323,-0.014077624596281146,46536400.0,-1.0
301,ACGL,2021-05-11,37.636566162109375,38.054960216158584,37.29424210543726,37.722143548887324,1805300.0,-0.32330322265625,0.32330322265625,0.0,43.90410848137894,37.256204052171924,39.25308899021667,19.047772993364546,-80.95222700663545,0.30613613705285303,0.4233638171081172,0.002279107638185174,44731100.0,-1.0
302,ACGL,2021-05-12,37.20866012573242,37.988396622411955,37.10406070808688,37.550984173521485,1674700.0,-0.4279060363769531,0.4279060363769531,0.0,38.40985435087129,37.10406070808688,39.25308899021667,4.867289021523814,-95.13271097847618,0.2185684868061557,0.3824047510477249,-0.025161926212337815,43056400.0,-1.0
303,ACGL,2021-05-13,37.959869384765625,38.026435622235496,36.84731979281377,36.91388240289344,1295200.0,0.7512092590332031,0.0,0.7512092590332031,50.86514085471035,36.84731979281377,39.25308899021667,46.245067613006526,-53.754932386993474,0.20739606938885657,0.3474030147159513,0.005288320930070478,44351600.0,1.0
304,ACGL,2021-05-14,38.216609954833984,38.46384559970261,37.988396342913674,38.283172560593236,2324200.0,0.2567405700683594,0.0,0.2567405700683594,54.494174260014745,36.84731979281377,39.25308899021667,56.91693797968671,-43.08306202031329,0.21675999216426334,0.32127441020561376,0.0012455785608975756,46675800.0,1.0
305,ACGL,2021-05-17,38.43531799316406,38.47335480607744,37.63656668632396,37.9408539348507,1460300.0,0.21870803833007812,0.0,0.21870803833007812,57.574167572991946,36.84731979281377,39.25308899021667,66.00791971501611,-33.99208028498389,0.23907299463570553,0.30483412709163216,0.003974210478906004,48136100.0,1.0
306,ACGL,2021-05-18,38.197593688964844,38.54942877041793,37.95986904725391,38.39728514481855,1497900.0,-0.23772430419921875,0.23772430419921875,0.0,53.06929186332088,36.84731979281377,39.09144101090047,60.16938324313406,-39.83061675686594,0.2348664509999594,0.29084059187329764,-0.0004975916464493579,46638200.0,-1.0
307,ACGL,2021-05-19,38.03594207763672,38.07397889028798,37.44638599110258,37.77919903332586,1886300.0,-0.161651611328125,0.161651611328125,0.0,49.99972484473425,36.84731979281377,39.09144101090047,52.96604636341119,-47.033953636588805,0.2159988999435143,0.27587225348734096,0.005783290182004297,44751900.0,-1.0
308,ACGL,2021-05-20,38.29268264770508,38.397282062042414,37.779196592261734,38.07397643017696,773600.0,0.2567405700683594,0.0,0.2567405700683594,54.79169816189802,36.84731979281377,39.09144101090047,64.40663023201579,-35.593369767984214,0.2192358339073408,0.26454496957134094,-0.012748259975910226,45525500.0,1.0
309,ACGL,2021-05-21,37.96937942504883,38.76813435284617,37.807724785163956,38.501883919377086,1058300.0,-0.32330322265625,0.32330322265625,0.0,48.094395762020866,36.84731979281377,39.09144101090047,49.99995647257005,-50.00004352742995,0.19348290875179686,0.2503325574074321,0.00025052879362696956,44467200.0,-1.0
310,ACGL,2021-05-24,37.96937942504883,38.21661145221439,37.703128991579746,38.092997252326654,1432000.0,0.0,0.0,0.0,48.09439576202087,36.84731979281377,39.09144101090047,49.99995647257005,-50.00004352742995,0.17110118210569425,0.23448628234708452,0.008842816889988114,44467200.0,1.0
311,ACGL,2021-05-25,37.2466926574707,38.15004696167442,37.18013005238737,37.99790334614253,1132600.0,-0.722686767578125,0.722686767578125,0.0,35.26589420731533,36.84731979281377,39.09144101090047,17.796403395598723,-82.20359660440127,0.09396554379347322,0.2063821346363623,0.0010221419317375524,43334600.0,-1.0
312,ACGL,2021-05-26,37.07553482055664,37.484417846182616,37.018479603604426,37.21816742185222,1059700.0,-0.1711578369140625,0.1711578369140625,0.0,32.86995825688932,36.84731979281377,39.09144101090047,10.169460807355248,-89.83053919264475,0.018807190105533778,0.1688671457301966,-0.023296564991972635,42274900.0,-1.0
313,ACGL,2021-05-27,37.73165512084961,37.83625454274847,37.21816902828617,37.541474683523504,2525700.0,0.6561203002929688,0.0,0.6561203002929688,48.38164584237801,36.84731979281377,39.09144101090047,39.406754007246064,-60.59324599275394,0.012048194045881644,0.1375033553933336,-0.012689635071177596,44800600.0,1.0
314,ACGL,2021-05-28,37.93134307861328,38.035942500873105,37.522456406537685,38.026435111299556,1188900.0,0.19968795776367188,0.0,0.19968795776367188,52.25581783873952,36.84731979281377,38.76813435284617,56.435603329726256,-43.564396670273744,0.02254490665169584,0.11451166564500605,-0.013112286846187038,45989500.0,1.0
315,ACGL,2021-06-01,37.90281677246094,38.20710401818205,37.598529526739824,38.03594198904016,2292400.0,-0.02852630615234375,0.02852630615234375,0.0,51.61724399269151,36.84731979281377,38.76813435284617,54.950488277710896,-45.0495117222891,0.02823630200139604,0.09725659291628405,-0.007717159329569623,43697100.0,-1.0
316,ACGL,2021-06-02,37.51294708251953,37.88379692239687,37.275222454147915,37.845760111283816,1531900.0,-0.38986968994140625,0.38986968994140625,0.0,43.277374987382814,36.84731979281377,38.76813435284617,34.6533863057834,-65.3466136942166,0.0012728752066948346,0.07805984937436622,-0.013750020810571195,42165200.0,-1.0
317,ACGL,2021-06-03,37.541473388671875,37.62705440114732,37.11356832629465,37.256204556217064,1292200.0,0.02852630615234375,0.0,0.02852630615234375,44.04070202758075,37.018479603604426,38.76813435284617,29.89125627750856,-70.10874372249144,-0.017591219656900137,0.05892963556811295,-0.019617566780169793,43457400.0,1.0
318,ACGL,2021-06-04,37.69361877441406,37.741162977486475,37.20866209925116,37.455894131661815,1064600.0,0.1521453857421875,0.0,0.1521453857421875,48.32059569051251,37.018479603604426,38.76813435284617,38.586993868488925,-61.413006131511075,-0.020033357571890065,0.043137036940112346,-0.007262711553638002,44522000.0,1.0
319,ACGL,2021-06-07,37.76018142700195,37.85527346064476,37.246695327501314,37.246695327501314,2555400.0,0.06656265258789062,0.0,0.06656265258789062,50.241678922310896,37.018479603604426,38.76813435284617,42.391324558114256,-57.60867544188575,-0.016408571885023093,0.031227915175085257,-0.0055096501763962635,47077400.0,1.0
320,ACGL,2021-06-08,37.62705612182617,37.769692358271314,37.142099447215,37.73165554490058,1435400.0,-0.13312530517578125,0.13312530517578125,0.0,46.27225696513836,37.018479603604426,38.76813435284617,34.7826631788636,-65.2173368211364,-0.024001330270863264,0.020182066085895553,0.010212006414995756,45642000.0,-1.0
321,ACGL,2021-06-09,37.14209747314453,37.56999890495702,37.09454964526316,37.455892098299685,2309700.0,-0.4849586486816406,0.4849586486816406,0.0,34.73659804785761,37.018479603604426,38.76813435284617,7.0652721397566065,-92.9347278602434,-0.06836271317083487,0.0024731102345494646,0.0017953254864711,43332300.0,-1.0
322,ACGL,2021-06-10,37.09455108642578,37.608037177418225,37.08504369691413,37.465404570402626,1530500.0,-0.04754638671875,0.04754638671875,0.0,33.783821169716404,37.018479603604426,38.76813435284617,4.347799636146654,-95.65220036385334,-0.10613259429023714,-0.019248030670407864,-0.01688513351410814,41801800.0,-1.0
323,ACGL,2021-06-11,37.36080551147461,37.37031290107855,37.01848144749014,37.19915086908632,1954000.0,0.2662544250488281,0.0,0.2662544250488281,43.75243699837745,37.018479603604426,38.21661145221439,28.57163911195084,-71.42836088804916,-0.11327522400365098,-0.03805346933705649,-0.015041322580015781,43755800.0,1.0
324,ACGL,2021-06-14,37.21816635131836,37.46540199027657,37.07553375412542,37.38932836986177,1381900.0,-0.14263916015625,0.14263916015625,0.0,40.02749902421419,37.018479603604426,38.20710401818205,16.799818787576523,-83.20018121242347,-0.12895903813327436,-0.05623458309630007,-0.018063312424843936,42373900.0,-1.0
325,ACGL,2021-06-15,37.58901596069336,37.788707399409624,36.98995252671411,37.199147726841375,1585300.0,0.370849609375,0.0,0.370849609375,52.228436740589075,36.98995252671411,38.20710401818205,49.21847758299583,-50.78152241700417,-0.11019386340602466,-0.06702643915824501,0.002027803307655285,43959200.0,1.0
326,ACGL,2021-06-16,37.45589065551758,37.74115947486749,37.35129124203165,37.45589065551758,1973600.0,-0.13312530517578125,0.13312530517578125,0.0,48.16939998666521,36.98995252671411,38.20710401818205,38.28103009934478,-61.71896990065522,-0.10485571537542882,-0.07459229440168177,-0.0022796849838110367,41985600.0,-1.0
327,ACGL,2021-06-17,36.619102478027344,37.693618882003776,36.44794407195615,37.427368442126145,2488700.0,-0.8367881774902344,0.8367881774902344,0.0,30.805505900554934,36.44794407195615,38.20710401818205,9.72955338361335,-90.27044661638665,-0.16623080198390028,-0.09291999591812548,-0.02850658364264258,39496900.0,-1.0
328,ACGL,2021-06-18,35.2973518371582,36.32432397380791,35.164226625531015,36.1151251398852,3403000.0,-1.3217506408691406,1.3217506408691406,0.0,18.591260718171995,35.164226625531015,38.20710401818205,4.374977840011034,-95.62502215998897,-0.31786112549780654,-0.1379082218340617,-0.06522292787721096,36093900.0,-1.0
329,ACGL,2021-06-21,36.03905487060547,36.15316167579006,35.43998779545399,35.61114981692584,1950400.0,0.7417030334472656,0.0,0.7417030334472656,35.22147287552983,35.164226625531015,37.88379692239687,32.167884981044345,-67.83211501895565,-0.3738702694521763,-0.18510063135768465,-0.04220370698359144,38044300.0,1.0
330,ACGL,2021-06-22,36.14365005493164,36.36235990001358,35.84887384418532,36.07708745073796,2002000.0,0.10459518432617188,0.0,0.10459518432617188,37.30541815848877,35.164226625531015,37.85527346064476,36.39562926296032,-63.60437073703969,-0.4051476721545413,-0.22911003951705602,-0.026881826448676316,40046300.0,1.0
331,ACGL,2021-06-23,36.5049934387207,36.80928067356501,36.10561780325879,36.219724609477915,2129400.0,0.3613433837890625,0.0,0.3613433837890625,44.43134634729822,35.164226625531015,37.85527346064476,49.82324334511319,-50.1767566548868,-0.39621057901639034,-0.26253014741692293,-0.01589337599291818,42175700.0,1.0
332,ACGL,2021-06-24,36.932899475097656,37.07553570719426,36.514505422945696,36.56204962451454,2031600.0,0.4279060363769531,0.0,0.4279060363769531,51.90134578452607,35.164226625531015,37.85527346064476,65.7243429021139,-34.2756570978861,-0.3505584082257087,-0.2801357995786801,-0.011453340754270736,44207300.0,1.0
333,ACGL,2021-06-25,37.37031173706055,37.49392956240228,36.81879247245674,36.932899281100624,4114000.0,0.4374122619628906,0.0,0.4374122619628906,58.483942469948964,35.164226625531015,37.788707399409624,84.05796428332192,-15.942035716678083,-0.2759027844786317,-0.27928919655867046,0.004087933411496492,48321300.0,1.0
334,ACGL,2021-06-28,36.85682678222656,37.44638650422953,36.628613157972,37.36080548828653,1278900.0,-0.5134849548339844,0.5134849548339844,0.0,49.33796316060567,35.164226625531015,37.788707399409624,64.49276266536049,-35.50723733463951,-0.2552294826749488,-0.27447725378192617,-0.019478806767180168,47042400.0,-1.0
335,ACGL,2021-06-29,36.98044204711914,37.161115083465475,36.771243216566496,36.932897847645336,1281800.0,0.12361526489257812,0.0,0.12361526489257812,51.447082677419544,35.164226625531015,37.788707399409624,69.20284727039618,-30.797152729603816,-0.2262628064821115,-0.2648343643219632,-0.012693560347320165,48324200.0,1.0
336,ACGL,2021-06-30,37.02798843383789,37.21816887035699,36.847319014209305,36.961425825164724,2118100.0,0.04754638671875,0.0,0.04754638671875,52.32788068737922,35.164226625531015,37.788707399409624,71.0144965380143,-28.9855034619857,-0.1971967494818827,-0.2513068413539471,0.01116591964688074,50442300.0,1.0
337,ACGL,2021-07-01,37.98839569091797,38.207101910000425,37.047004582581415,37.208659213357954,1892900.0,0.9604072570800781,0.0,0.9604072570800781,66.49442425110414,35.164226625531015,38.207101910000425,92.81251452536635,-7.187485474633651,-0.09556325697161583,-0.22015812447748084,0.07623925630950179,52335200.0,1.0
338,ACGL,2021-07-02,37.56999969482422,38.27366621001652,37.45589288576792,38.06446737058826,1505100.0,-0.41839599609375,0.41839599609375,0.0,57.85265388431544,35.164226625531015,38.27366621001652,77.36998915485496,-22.63001084514504,-0.04822315561083457,-0.18577113070415158,0.04248016019608314,50830100.0,-1.0
339,ACGL,2021-07-06,36.89486312866211,37.484419215816764,36.56205008608854,37.42736762416993,1523500.0,-0.6751365661621094,0.6751365661621094,0.0,46.5811949182611,35.164226625531015,38.27366621001652,55.65750535132036,-44.34249464867964,-0.06444082898919845,-0.16150507036116096,0.020784095479807974,49306600.0,-1.0
340,ACGL,2021-07-07,37.104061126708984,37.20866054553466,36.628611861057756,36.69517446805772,1041400.0,0.209197998046875,0.0,0.209197998046875,50.05991830577139,35.164226625531015,38.27366621001652,62.38534142476152,-37.61465857523848,-0.05972445553563688,-0.14114894739605616,0.01641056829646903,50348000.0,1.0
341,ACGL,2021-07-08,35.77280044555664,36.676154743287796,35.56360524281788,36.676154743287796,2808500.0,-1.3312606811523438,1.3312606811523438,0.0,33.866222596816954,35.164226625531015,38.27366621001652,19.57181683355721,-80.42818316644279,-0.16154610382699275,-0.14522837868224348,-0.0314109925304733,47539500.0,-1.0
342,ACGL,2021-07-09,36.60959243774414,36.6666476538971,36.096106374537264,36.25776100660902,1891600.0,0.8367919921875,0.0,0.8367919921875,46.43373963423537,35.43998779545399,38.27366621001652,41.275136807318965,-58.724863192681035,-0.17272728070345522,-0.15072815908648585,-0.020356247083751056,49431100.0,1.0
343,ACGL,2021-07-12,36.495487213134766,36.733211849647695,36.181688951790456,36.34334359086209,1133100.0,-0.114105224609375,0.114105224609375,0.0,45.08570533301213,35.56360524281788,38.27366621001652,34.3860149862297,-65.6139850137703,-0.18862147103754978,-0.15830682147669864,-0.009803870833124617,48298000.0,-1.0
344,ACGL,2021-07-13,35.69673156738281,36.46695705257711,35.630168960696636,36.42892386832073,1091700.0,-0.7987556457519531,0.7987556457519531,0.0,36.521737468807835,35.56360524281788,38.27366621001652,4.91229998794252,-95.08770001205748,-0.2626430509199338,-0.1791740673653457,-0.03471322701066337,47206300.0,-1.0
345,ACGL,2021-07-14,35.896419525146484,36.04856314492567,35.5921322855881,35.848875324101115,1646500.0,0.19968795776367188,0.0,0.19968795776367188,39.8192006423341,35.56360524281788,38.27366621001652,12.280693547371808,-87.7193064526282,-0.30171455931482427,-0.20368216575524142,-0.030559826675794377,48852800.0,1.0
346,ACGL,2021-07-15,36.11512756347656,36.21021959772734,35.497045664102465,35.573115664112876,961800.0,0.21870803833007812,0.0,0.21870803833007812,43.526522012232974,35.497045664102465,38.27366621001652,22.260222063242928,-77.73977793675706,-0.31144100232937433,-0.225233933070068,-0.049311588272448525,49814600.0,1.0
347,ACGL,2021-07-16,36.2102165222168,36.35284912039317,36.010525080946046,36.181687100669606,939000.0,0.09508895874023438,0.0,0.09508895874023438,45.219463004511596,35.497045664102465,38.27366621001652,25.684851290314047,-74.31514870968596,-0.3079268056768427,-0.24177250759142294,-0.03619332402589159,50753600.0,1.0
348,ACGL,2021-07-19,35.0120849609375,35.91543932543162,34.73632350582211,35.69673309021981,1849400.0,-1.1981315612792969,1.1981315612792969,0.0,31.49355032706454,34.73632350582211,38.27366621001652,7.795723461806754,-92.20427653819324,-0.39724182679820785,-0.27286637143278,-0.051030902626169605,48904200.0,-1.0
349,ACGL,2021-07-20,36.029544830322266,36.51450511342789,35.107172092666886,35.221282528332935,2634400.0,1.0174598693847656,0.0,1.0174598693847656,47.19811618577538,34.73632350582211,38.27366621001652,36.55911888228183,-63.44088111771817,-0.381526120696968,-0.2945983212856176,-0.028959533370681023,51538600.0,1.0
350,ACGL,2021-07-21,36.590576171875,36.90437443797973,36.362362548698954,36.362362548698954,1035900.0,0.5610313415527344,0.0,0.5610313415527344,53.91910430482735,34.73632350582211,38.27366621001652,52.41936733622692,-47.58063266377307,-0.32011073259417344,-0.29970080354732875,0.02286026579224476,52574500.0,1.0
351,ACGL,2021-07-22,36.25776290893555,36.504994937123314,36.06758247250412,36.45745073486299,1074800.0,-0.3328132629394531,0.3328132629394531,0.0,49.597866982645506,34.73632350582211,38.27366621001652,43.01080020630709,-56.98919979369291,-0.2948944838866083,-0.2987395396151847,-0.009610309904621084,51499700.0,-1.0
352,ACGL,2021-07-23,36.638118743896484,36.74271816127636,36.37186831957679,36.64762976041646,1039800.0,0.3803558349609375,0.0,0.3803558349609375,54.415362503419765,34.73632350582211,37.484419215816764,69.20411218421773,-30.795887815782265,-0.24143576676689804,-0.28727878504552734,0.003908196373122674,52539500.0,1.0
353,ACGL,2021-07-26,36.80928039550781,36.98044241723852,36.49548577392814,36.54302997387779,1137700.0,0.17116165161132812,0.0,0.17116165161132812,56.5707200501004,34.73632350582211,37.20866054553466,83.84604754078012,-16.153952459219877,-0.1831468308122055,-0.26645239419886296,0.03116668611592366,53677200.0,1.0
354,ACGL,2021-07-27,36.638118743896484,36.932898590386124,36.35284991392682,36.59057454346654,1709900.0,-0.17116165161132812,0.17116165161132812,0.0,53.644072231181674,34.73632350582211,36.98044241723852,84.74574267876147,-15.254257321238526,-0.14904563860229558,-0.24297104307954948,0.02066220610750369,51967300.0,-1.0
355,ACGL,2021-07-28,36.191200256347656,36.88535576519788,35.92494619471091,36.771245327043516,2041300.0,-0.4469184875488281,0.4469184875488281,0.0,46.410327927525884,34.73632350582211,36.98044241723852,64.83064436221336,-35.16935563778663,-0.15628127176246664,-0.22563308881613295,0.002106394134629319,49926000.0,-1.0
356,ACGL,2021-07-29,36.60959243774414,36.85682445296046,35.89641855908679,36.695173448278624,4177400.0,0.4183921813964844,0.0,0.4183921813964844,53.223813952791126,34.73632350582211,36.98044241723852,83.47458427413224,-16.525415725867756,-0.12679321749723726,-0.20586511455235382,0.011029371097030172,54103400.0,1.0
357,ACGL,2021-07-30,37.08504104614258,37.51294609138374,36.609591801961265,36.71419121606353,2488500.0,0.4754486083984375,0.0,0.4754486083984375,59.907543443436566,34.73632350582211,37.51294609138374,84.58900941502614,-15.41099058497386,-0.06431757981042807,-0.17755560760396868,0.05920687349861753,56591900.0,1.0
358,ACGL,2021-08-02,37.28472900390625,37.71263405082049,37.0850411911429,37.25620320990859,3166400.0,0.19968795776367188,0.0,0.19968795776367188,62.50396722292951,34.73632350582211,37.71263405082049,85.62297043790258,-14.377029562097418,0.0012930569431048866,-0.14178587469455398,0.03483763615374991,59758300.0,1.0
359,ACGL,2021-08-03,37.408348083496094,37.76969053832625,36.69517419041525,37.51294750153035,2236600.0,0.12361907958984375,0.0,0.12361907958984375,64.16179968875875,34.73632350582211,37.76969053832625,88.08774371982747,-11.912256280172526,0.06254401736464388,-0.1009198962827144,0.022349249374478797,61994900.0,1.0
360,ACGL,2021-08-04,37.48441696166992,38.04544721926329,37.11356712870632,37.23718494882415,1311100.0,0.07606887817382812,0.0,0.07606887817382812,65.25260436702084,34.73632350582211,38.04544721926329,83.04595699113507,-16.95404300886492,0.11588808185276633,-0.057558300655618254,0.033831487502834046,63306000.0,1.0
361,ACGL,2021-08-05,38.026432037353516,38.03593942615852,37.4178539595275,37.646071192135985,1219700.0,0.5420150756835938,0.0,0.5420150756835938,72.20737265317658,34.73632350582211,38.04544721926329,99.42537107837536,-0.5746289216246351,0.19959887252499442,-0.0061268660194957044,0.03789259222509367,64525700.0,1.0
362,ACGL,2021-08-06,38.58746337890625,38.67304076273802,38.26415773955639,38.42580874553634,1050300.0,0.5610313415527344,0.0,0.5610313415527344,77.56935950460885,35.107172092666886,38.67304076273802,97.60009715023908,-2.399902849760917,0.30766425573931855,0.056631358332267165,0.048308007227857885,65576000.0,1.0
363,ACGL,2021-08-09,38.5494270324707,38.75862224111973,38.26415820075657,38.56844543823698,1090500.0,-0.038036346435546875,0.038036346435546875,0.0,76.41606456689632,35.89641855908679,38.75862224111973,92.69111384482454,-7.3088861551754665,0.38579048269312466,0.12246318320443869,0.052167206016619616,64485500.0,-1.0
364,ACGL,2021-08-10,38.77764129638672,39.1484911465656,38.47335405380969,38.49237245989452,1127100.0,0.22821426391601562,0.0,0.22821426391601562,78.61701567681199,35.89641855908679,39.1484911465656,88.59650760543502,-11.403492394564974,0.4608091432947461,0.1901323752225002,0.0714660199639392,65612600.0,1.0
365,ACGL,2021-08-11,39.48130798339844,39.62394058856884,38.62549784281571,38.79665987093225,1488900.0,0.7036666870117188,0.0,0.7036666870117188,83.94696779860317,35.89641855908679,39.62394058856884,96.1735275058797,-3.8264724941202912,0.5704660160257546,0.26619910338315117,0.07844161473629474,67101500.0,1.0
366,ACGL,2021-08-12,39.61443328857422,39.823632129497646,39.31014604398928,39.46228966628175,1405400.0,0.13312530517578125,0.0,0.13312530517578125,84.77537366297969,35.89641855908679,39.823632129497646,94.67309742205995,-5.3269025779400545,0.6604981655466773,0.3450589158158564,0.06820518923747398,68506900.0,1.0
367,ACGL,2021-08-13,39.728538513183594,39.86166372395374,39.5859059133827,39.747556918635034,1198100.0,0.114105224609375,0.0,0.114105224609375,85.51465177542872,35.89641855908679,39.86166372395374,96.6426991211119,-3.357300878888099,0.732611540888918,0.4225694408304688,0.06554451579951981,69705000.0,1.0
368,ACGL,2021-08-16,39.7570686340332,39.89970123634175,39.24358255998643,39.4432703796524,993000.0,0.028530120849609375,0.0,0.028530120849609375,85.71477353987281,35.89641855908679,39.89970123634175,96.43710889768225,-3.5628911023177605,0.7830376817417672,0.49466308901272854,0.06278600020762015,70698000.0,1.0
369,ACGL,2021-08-17,39.8426513671875,40.28006383698299,39.633452521898285,39.74755933415142,1172600.0,0.08558273315429688,0.0,0.08558273315429688,86.36669744107527,35.89641855908679,40.28006383698299,90.02171840862513,-9.97828159137486,0.8204489482257813,0.5598202608553392,0.06291239391368997,71870600.0,1.0
370,ACGL,2021-08-18,39.63344955444336,40.09938778556864,39.58590535518015,39.71903056407309,1133300.0,-0.20920181274414062,0.20920181274414062,0.0,76.51756226619786,36.609591801961265,40.28006383698299,82.38334807158384,-17.616651928416157,0.8237214602866487,0.6126005007416011,0.04226053907743088,70737300.0,-1.0
371,ACGL,2021-08-19,39.61443328857422,39.833139518907764,39.2435834359482,39.34818285640991,1077700.0,-0.019016265869140625,0.019016265869140625,0.0,75.613169804683,36.69517419041525,40.28006383698299,81.432328076094,-18.567671923906,0.8153812880110252,0.653156658195486,0.026614081873787,69659600.0,-1.0
372,ACGL,2021-08-20,40.0328254699707,40.08037329696687,39.34818101538285,39.557376219128344,1722700.0,0.4183921813964844,0.0,0.4183921813964844,81.24170509609873,36.69517419041525,40.28006383698299,93.10332000738157,-6.896679992618426,0.8329308850231456,0.6891115035610179,0.03848042764035142,71382300.0,1.0
373,ACGL,2021-08-23,40.0328254699707,40.29907951706757,39.909211276472426,40.01381069204013,1078100.0,0.0,0.0,0.0,81.24170509609873,37.11356712870632,40.29907951706757,91.6417199295892,-8.358280070410798,0.83718847943409,0.7187268987356324,0.03236876023454638,71382300.0,1.0
374,ACGL,2021-08-24,39.97577667236328,40.45122595639979,39.94724724869578,39.98528406199234,2186300.0,-0.057048797607421875,0.057048797607421875,0.0,77.97468058844976,37.4178539595275,40.45122595639979,84.32604756268789,-15.67395243731211,0.8264326908650403,0.7402680571615141,0.012524121267025068,69196000.0,-1.0
375,ACGL,2021-08-25,40.01381301879883,40.242026641135176,39.8426509883515,39.890195190722395,1615800.0,0.038036346435546875,0.0,0.038036346435546875,78.63562326649412,38.26415773955639,40.45122595639979,80.00003227003685,-19.999967729963153,0.811621993087968,0.754538844346805,0.010081672185369817,70811800.0,1.0
376,ACGL,2021-08-26,39.357688903808594,40.118406989332115,39.338670498246756,40.099388583770285,1375100.0,-0.6561241149902344,0.6561241149902344,0.0,49.231011410289405,38.26415820075657,40.45122595639979,49.999854838992675,-50.000145161007325,0.7384285313193928,0.7513167817413227,-0.009334589774852575,69436700.0,-1.0
377,ACGL,2021-08-27,39.70001220703125,39.90921103691091,39.376706573303544,39.75706742265022,2677900.0,0.34232330322265625,0.0,0.34232330322265625,58.55964360806645,38.47335405380969,40.45122595639979,62.01908989228288,-37.98091010771713,0.6999759284094154,0.7410486110749412,-0.0014351266067215152,72114600.0,1.0
378,ACGL,2021-08-30,39.22456359863281,39.92823009318108,39.14848997656707,39.709520243437055,1544600.0,-0.4754486083984375,0.4754486083984375,0.0,45.23847232159988,38.62549784281571,40.45122595639979,32.81242981141798,-67.18757018858201,0.6239447872440707,0.7176278463087672,-0.015513218808116624,70570000.0,-1.0
379,ACGL,2021-08-31,39.08192825317383,39.452781728030864,38.92978463299788,39.14849086028893,1876400.0,-0.14263534545898438,0.14263534545898438,0.0,41.93625876844705,38.92978463299788,40.45122595639979,9.999966336904716,-90.00003366309528,0.5458874292888112,0.6832797629047761,-0.01391555132015243,68693600.0,-1.0
380,ACGL,2021-09-01,38.48286437988281,39.16750884969856,38.473353363316065,39.04389465345085,1156100.0,-0.5990638732910156,0.5990638732910156,0.0,30.977945438786094,38.473353363316065,40.45122595639979,0.480871042958286,-99.51912895704172,0.4307218691549082,0.6327681841548025,-0.028564561316538617,67537500.0,-1.0
381,ACGL,2021-09-02,37.66509246826172,38.43531797882449,37.51294884405511,38.42581058929476,1740200.0,-0.8177719116210938,0.8177719116210938,0.0,21.94548335038371,37.51294884405511,40.45122595639979,5.177987588965072,-94.82201241103493,0.2703485642009795,0.560284260164038,-0.05914478865562611,65797300.0,-1.0
382,ACGL,2021-09-03,37.49393081665039,37.769692271872096,37.18964356516098,37.60803762911137,1975200.0,-0.17116165161132812,0.17116165161132812,0.0,20.50181314485218,37.18964356516098,40.45122595639979,9.329436297754807,-90.67056370224519,0.12796514720881902,0.4738204375729942,-0.0634203212867096,63822100.0,-1.0
383,ACGL,2021-09-07,37.08504104614258,37.474909281275664,36.79977222511177,37.474909281275664,2280800.0,-0.4088897705078125,0.4088897705078125,0.0,17.354851629166234,36.79977222511177,40.45122595639979,7.812472566376605,-92.1875274336234,-0.017665091639891273,0.3755233317304171,-0.07231218169725206,61541300.0,-1.0
384,ACGL,2021-09-08,38.007415771484375,38.07397837903524,36.86633679899952,37.00896940344134,2883500.0,0.9223747253417969,0.0,0.9223747253417969,40.94788076679601,36.79977222511177,40.45122595639979,33.07295217860043,-66.92704782139958,-0.057981795364312916,0.2888223063114711,-0.05014261566054279,64424800.0,1.0
385,ACGL,2021-09-09,37.57950973510742,38.482864049523414,37.531965534851835,38.035940586862985,2384600.0,-0.4279060363769531,0.4279060363769531,0.0,35.520022504698034,36.79977222511177,40.45122595639979,21.35416651495154,-78.64583348504847,-0.12304314967003904,0.20644921511516906,-0.045179969104565454,62040200.0,-1.0
386,ACGL,2021-09-10,37.02798843383789,37.93134278676104,36.999462637946564,37.83625438219655,1623200.0,-0.5515213012695312,0.5515213012695312,0.0,29.670912877960276,36.79977222511177,40.45122595639979,6.250009599481427,-93.74999040051857,-0.21661094531373948,0.12183718302938736,-0.06730536402001708,60417000.0,-1.0
387,ACGL,2021-09-13,37.93134307861328,38.06446829698392,37.24669495283272,37.35129437509254,2359600.0,0.9033546447753906,0.0,0.9033546447753906,46.3634180950198,36.79977222511177,40.45122595639979,30.989598575643512,-69.01040142435649,-0.21538806772699104,0.05439213287811166,-0.03296965986039946,62776600.0,1.0
388,ACGL,2021-09-14,37.332275390625,38.264159159573495,37.237186986800914,37.98839771013751,1953100.0,-0.5990676879882812,0.5990676879882812,0.0,39.237325542925255,36.79977222511177,40.242026641135176,15.469605123737376,-84.53039487626263,-0.25976428327231815,-0.00843915035197432,-0.044768846900657744,60823500.0,-1.0
389,ACGL,2021-09-15,37.408348083496094,37.655580103712516,36.91388041567324,37.20866026400706,2510200.0,0.07607269287109375,0.0,0.07607269287109375,40.57558924084137,36.79977222511177,40.118406989332115,18.338139072899782,-81.66186092710022,-0.28550321985774474,-0.06385196425312842,-0.02792194171877782,63333700.0,1.0
390,ACGL,2021-09-16,37.237186431884766,37.6460730915372,37.20866063664066,37.5414736724554,1979500.0,-0.17116165161132812,0.17116165161132812,0.0,38.38103134725554,36.79977222511177,39.92823009318108,13.981783524639372,-86.01821647536063,-0.3160693763440108,-0.11429544667130491,-0.011360812049977742,61354200.0,-1.0
391,ACGL,2021-09-17,37.37031173706055,37.54147376372139,37.08504290175582,37.20866072709755,4357600.0,0.13312530517578125,0.0,0.13312530517578125,41.23345744828246,36.79977222511177,39.92823009318108,18.23708472381895,-81.76291527618105,-0.32579560706601285,-0.15659547875024651,-0.0032970423985245745,65711800.0,1.0
392,ACGL,2021-09-20,36.942405700683594,37.27522235596116,36.504993256205594,37.02798671176755,1960400.0,-0.4279060363769531,0.4279060363769531,0.0,35.19154991166474,36.504993256205594,39.452781728030864,14.838664600894983,-85.16133539910501,-0.36383805731912133,-0.19804399446402152,-0.0038461692756794896,63751400.0,-1.0
393,ACGL,2021-09-21,36.82830047607422,37.28473134565323,36.76173786763916,37.170624535106,1287400.0,-0.114105224609375,0.114105224609375,0.0,33.67339445729347,36.504993256205594,39.16750884969856,12.142923055878772,-87.85707694412123,-0.39859950426895807,-0.23815509642500884,-0.0310232956247134,62464000.0,-1.0
394,ACGL,2021-09-22,37.104061126708984,37.32276735362175,37.00896909714472,37.17062373370896,1727000.0,0.2757606506347656,0.0,0.2757606506347656,40.79548292967346,36.504993256205594,38.482864049523414,30.28852402934124,-69.71147597065875,-0.39929381103919326,-0.27038283934784574,-0.012651804447418424,64191000.0,1.0
395,ACGL,2021-09-23,37.08504104614258,37.60803448926406,37.04700423603451,37.29423987434711,1557900.0,-0.01902008056640625,0.01902008056640625,0.0,40.44981104792447,36.504993256205594,38.482864049523414,29.32687978894571,-70.6731202110543,-0.39680469814323516,-0.2956672111069236,0.0015407969678566946,62633100.0,-1.0
396,ACGL,2021-09-24,37.25620651245117,37.34178752942027,36.90437505486274,37.1516070886678,6199100.0,0.17116546630859375,0.0,0.17116546630859375,45.265565275630784,36.504993256205594,38.482864049523414,37.98090647698172,-62.01909352301828,-0.3766783223722925,-0.3118694333599974,-0.01779891011934054,68832200.0,1.0
397,ACGL,2021-09-27,37.4273681640625,37.74116280481693,37.40834975744251,37.493930773537386,2456000.0,0.17116165161132812,0.0,0.17116165161132812,49.936862114300034,36.504993256205594,38.482864049523414,46.63474029613679,-53.36525970386321,-0.342963242965979,-0.31808819528119375,0.0025472000418538254,71288200.0,1.0
398,ACGL,2021-09-28,36.5049934387207,37.65557977218761,36.43843083281038,37.3037483370345,2308700.0,-0.9223747253417969,0.9223747253417969,0.0,32.62415629203518,36.43843083281038,38.482864049523414,3.255797517188525,-96.74420248281147,-0.3862196318576281,-0.3317144825964807,-0.024148477306698668,68979500.0,-1.0
399,ACGL,2021-09-29,36.932899475097656,37.15160570422641,36.238743975500284,36.466957593986784,1752000.0,0.4279060363769531,0.0,0.4279060363769531,43.170592996942645,36.238743975500284,38.264159159573495,34.272257118236396,-65.7277428817636,-0.3815736472400246,-0.3416863155251895,-0.008171588295042609,70731500.0,1.0
400,ACGL,2021-09-30,36.30530548095703,37.161115592774436,36.28628707542887,36.923390964757374,2374900.0,-0.627593994140625,0.627593994140625,0.0,34.129684395268015,36.238743975500284,38.264159159573495,3.2863141335243804,-96.71368586647561,-0.4236496913344254,-0.35807899068703675,-0.028498725501594824,68356600.0,-1.0
401,ACGL,2021-10-01,36.30530548095703,36.56204851450225,36.048562447411804,36.27677968635977,2014000.0,0.0,0.0,0.0,34.129684395268015,36.048562447411804,38.264159159573495,11.587985852115242,-88.41201414788475,-0.45178733623648526,-0.37682065979692647,-0.017245769668832733,68356600.0,1.0
402,ACGL,2021-10-04,36.31481170654297,36.790260947344265,35.60163784534102,35.744274068537344,2577900.0,0.0095062255859375,0.0,0.0095062255859375,34.40670283400334,35.60163784534102,37.74116280481693,33.33328073801238,-66.66671926198762,-0.4679255946031873,-0.3950416467581787,-0.013942776693288916,70934500.0,1.0
403,ACGL,2021-10-05,37.65557861328125,37.86477744106954,36.21972349476212,36.54302912525773,1997800.0,1.3407669067382812,0.0,1.3407669067382812,61.058433784859105,35.60163784534102,37.86477744106954,90.75625612387604,-9.243743876123952,-0.368281279172308,-0.3896895732410046,0.01486407336083384,72932300.0,1.0
404,ACGL,2021-10-06,38.026432037353516,38.04544681496352,37.427364975722355,37.48441656333209,1435200.0,0.3708534240722656,0.0,0.3708534240722656,65.52858292821531,35.60163784534102,38.04544681496352,99.22192045915355,-0.7780795408464598,-0.25643168448796416,-0.36303799549039656,0.025384655501381914,74367500.0,1.0
405,ACGL,2021-10-07,38.71107864379883,38.88224067097325,38.102504159351994,38.21661096833826,1349700.0,0.6846466064453125,0.0,0.6846466064453125,72.30151459367242,35.60163784534102,38.88224067097325,94.78260440925399,-5.217395590746006,-0.11126225355744168,-0.3126828471038056,0.0390504634673805,75717200.0,1.0
406,ACGL,2021-10-08,38.93929672241211,39.27210976715635,38.520899034859205,38.796660487584504,1117500.0,0.22821807861328125,0.0,0.22821807861328125,74.24762025602548,35.60163784534102,39.27210976715635,90.9326906230728,-9.067309376927202,0.02194785675964539,-0.2457567063311154,0.040396336491577145,76834700.0,1.0
407,ACGL,2021-10-11,38.197593688964844,39.24358428892703,38.18808629934808,39.11045906995133,1906100.0,-0.7417030334472656,0.7417030334472656,0.0,58.76464475004719,35.60163784534102,39.27210976715635,70.72539714021092,-29.274602859789095,0.06689744073011639,-0.18322587691886905,0.04636626638723906,74928600.0,-1.0
408,ACGL,2021-10-12,38.84420394897461,39.41474525000983,38.739608156472045,39.024876993294626,2331600.0,0.6466102600097656,0.0,0.6466102600097656,65.91456465184893,35.60163784534102,39.41474525000983,85.03736610364967,-14.962633896350333,0.152933432494315,-0.11599401503623223,0.051750729052986166,77260200.0,1.0
409,ACGL,2021-10-13,39.7570686340332,39.823631240588526,38.04544838721063,38.74911489172546,2128200.0,0.9128646850585938,0.0,0.9128646850585938,73.42164758158314,35.60163784534102,39.823631240588526,98.42343176968849,-1.5765682303115136,0.2914188318869577,-0.03451144565159422,0.09507599804900968,79388400.0,1.0
410,ACGL,2021-10-14,40.698455810546875,40.83158102257204,39.83313830499335,39.98528192264924,1763200.0,0.9413871765136719,0.0,0.9413871765136719,78.94061500773766,35.60163784534102,40.83158102257204,97.4545572004542,-2.54544279954579,0.47169418928812235,0.06672968133634914,0.12100573928221459,81151600.0,1.0
411,ACGL,2021-10-15,40.38466262817383,40.936181901598914,40.2230079882352,40.86011190374963,1169900.0,-0.3137931823730469,0.3137931823730469,0.0,73.10234450576728,35.60163784534102,40.936181901598914,89.66136060347829,-10.338639396521707,0.5825281990366307,0.16988938487640548,0.11207137612385254,79981700.0,-1.0
412,ACGL,2021-10-18,40.27054977416992,40.38466020518261,39.18652607127855,40.08988036615132,966300.0,-0.11411285400390625,0.11411285400390625,0.0,70.90204677718273,35.60163784534102,40.936181901598914,87.52223019607183,-12.477769803928158,0.6536224439727647,0.2666359966956774,0.06944445570055224,79015400.0,-1.0
413,ACGL,2021-10-19,40.00429916381836,40.612873616727306,39.84264816174748,40.593855211650165,1094800.0,-0.2662506103515625,0.2662506103515625,0.0,65.58739880549047,35.60163784534102,40.936181901598914,82.53116427659131,-17.468835723408695,0.680635009476191,0.34943579925178014,0.05201295573883913,77920600.0,-1.0
414,ACGL,2021-10-20,40.54631423950195,40.87913091375405,39.947247127760306,39.98528394094171,1594200.0,0.5420150756835938,0.0,0.5420150756835938,70.73931591649682,35.60163784534102,40.936181901598914,92.6916404104,-7.308359589600003,0.7372798459282492,0.427004608587074,0.04740853678064871,79514800.0,1.0
415,ACGL,2021-10-21,40.80305480957031,40.8220732150061,40.394168161175756,40.394168161175756,1263500.0,0.2567405700683594,0.0,0.2567405700683594,72.95246230832073,35.60163784534102,40.936181901598914,97.50443354437327,-2.4955664556267307,0.793738383257363,0.5003513635211319,0.047863167648980465,80778300.0,1.0
416,ACGL,2021-10-22,41.08832550048828,41.26899854663034,40.71747564613998,40.82207506708747,1158400.0,0.28527069091796875,0.0,0.28527069091796875,75.34340580907597,36.21972349476212,41.26899854663034,96.42180225307368,-3.5781977469263175,0.8516834646766824,0.570617783752242,0.07567837479664474,81936700.0,1.0
417,ACGL,2021-10-25,41.21194076538086,41.345065973804196,40.6033663112228,41.050286135588316,1073300.0,0.12361526489257812,0.0,0.12361526489257812,76.38705511589424,37.427364975722355,41.345065973804196,96.60195587951922,-3.398044120480783,0.8972372850430546,0.6359416840104046,0.06095470046230034,83010000.0,1.0
418,ACGL,2021-10-26,41.031272888183594,41.3640859216547,40.97421767070712,41.25948650330949,1074900.0,-0.18066787719726562,0.18066787719726562,0.0,71.2977983199882,38.04544838721063,41.3640859216547,89.97139548935836,-10.028604510641642,0.9082904215076013,0.6904114315098441,0.03204975361437068,81935100.0,-1.0
419,ACGL,2021-10-27,40.25153732299805,41.57328572581366,40.24202630616896,41.14538065325715,1725200.0,-0.7797355651855469,0.7797355651855469,0.0,53.535757659626164,38.04544838721063,41.57328572581366,62.53374869775018,-37.46625130224982,0.8443982705575408,0.7212087993193835,-0.010981214855650845,80209900.0,-1.0
420,ACGL,2021-10-28,39.97577667236328,40.983726832990975,39.59541579417801,40.7935500212885,1494500.0,-0.2757606506347656,0.2757606506347656,0.0,48.5955407466639,38.04544838721063,41.57328572581366,54.71704332935692,-45.28295667064309,0.7627195445995056,0.7295109483754081,-0.01012478325187971,78715400.0,-1.0
421,ACGL,2021-10-29,39.76657485961914,40.394167722626726,39.72853804916053,40.1279173041962,2141100.0,-0.20920181274414062,0.20920181274414062,0.0,44.96355789910712,38.04544838721063,41.57328572581366,48.78701332329714,-51.21298667670287,0.6733458164693218,0.7182779219941909,-0.01251472645337559,76574300.0,-1.0
422,ACGL,2021-11-01,40.47975158691406,40.55582521319567,39.842651290061326,39.86166606924157,1629800.0,0.7131767272949219,0.0,0.7131767272949219,57.46752119095928,38.04544838721063,41.57328572581366,69.00270522867643,-30.997294771323574,0.6525417989837905,0.7051306973921109,0.011885033184776406,78204100.0,1.0
423,ACGL,2021-11-02,41.04077911376953,41.19292272866973,40.19448002917532,40.33711262773743,1638700.0,0.5610275268554688,0.0,0.5610275268554688,64.73905740931356,39.18652607127855,41.57328572581366,77.68913970737236,-22.310860292627627,0.6735603139339332,0.6988166207004755,0.012195063436514442,79842800.0,1.0
424,ACGL,2021-11-03,41.12636184692383,41.478193290985516,40.92667402413665,41.05028822259153,1675900.0,0.08558273315429688,0.0,0.08558273315429688,65.76914259850574,39.18652607127855,41.57328572581366,81.27486870994203,-18.72513129005797,0.6891790230047974,0.69688910116134,0.007923598830097411,81518700.0,1.0
425,ACGL,2021-11-04,40.10890197753906,40.974219531245886,39.92823255507814,40.974219531245886,1610800.0,-1.0174598693847656,1.0174598693847656,0.0,46.95327777689143,39.18652607127855,41.57328572581366,38.64552949468098,-61.354470505319014,0.6123971214654631,0.6799907052221646,-0.023837026966153196,79907900.0,-1.0
426,ACGL,2021-11-05,41.230960845947266,41.30703084211325,40.213499708920885,40.251536520698885,1283700.0,1.1220588684082031,0.0,1.1220588684082031,61.11056153845929,39.59541579417801,41.57328572581366,82.69224510717439,-17.307754892825617,0.6347704459846923,0.6709466533746703,0.00046151868155619447,81191600.0,1.0
427,ACGL,2021-11-08,40.52729415893555,41.48770370145065,40.49876836392282,41.38310428321732,794300.0,-0.7036666870117188,0.7036666870117188,0.0,51.219250524910926,39.59541579417801,41.57328572581366,47.11525009063137,-52.88474990936864,0.5889325976158091,0.6545438422228981,-0.01228279538442456,80397300.0,-1.0
428,ACGL,2021-11-09,39.956756591796875,40.48926107346988,39.86166456253919,40.21349962970761,2336300.0,-0.5705375671386719,0.5705375671386719,0.0,44.48328849580278,39.59541579417801,41.57328572581366,18.26918908262309,-81.7308109173769,0.5007953025394798,0.6237941342862144,-0.007323465159497111,78061000.0,-1.0
429,ACGL,2021-11-10,39.70952224731445,40.75551283916287,39.64295963834293,39.9567579041145,3788000.0,-0.24723434448242188,0.24723434448242188,0.0,41.738696725922914,39.59541579417801,41.57328572581366,5.769158593865682,-94.23084140613432,0.4063123994008606,0.5802977873091437,-0.006660394048901619,74273000.0,-1.0
430,ACGL,2021-11-11,39.43376159667969,39.757067228831254,39.1580001636172,39.7095194023523,7151800.0,-0.2757606506347656,0.2757606506347656,0.0,38.66821578571797,39.1580001636172,41.57328572581366,11.41734283426542,-88.58265716573457,0.3056589914849184,0.5253700281442987,-0.008369170946060267,67121200.0,-1.0
431,ACGL,2021-11-12,39.956756591796875,40.30858803157528,38.94880284600547,39.48130732767848,3561600.0,0.5229949951171875,0.0,0.5229949951171875,47.17254990613125,38.94880284600547,41.57328572581366,38.405803807913195,-61.594196192086805,0.26503658897910043,0.47330334031125904,-0.012919916121378994,70682800.0,1.0
432,ACGL,2021-11-15,40.28006362915039,40.80305711228479,40.10890159795875,40.10890159795875,1754300.0,0.3233070373535156,0.0,0.3233070373535156,51.92721099873482,38.94880284600547,41.57328572581366,50.724689171613655,-49.27531082838634,0.25598043513546287,0.4298387592760998,-0.0185356004697268,72437100.0,1.0
433,ACGL,2021-11-16,40.59385681152344,41.20243491580736,40.46073159812665,40.508275798998355,1581300.0,0.3137931823730469,0.0,0.3137931823730469,56.32900079371768,38.94880284600547,41.48770370145065,64.79394270122133,-35.20605729877867,0.2709999367277689,0.39807099476643365,-0.012948021937423615,74018400.0,1.0
434,ACGL,2021-11-17,40.08037567138672,40.50827712058241,39.918721030280906,40.289570887525244,1518800.0,-0.5134811401367188,0.5134811401367188,0.0,48.025996458459616,38.94880284600547,41.48770370145065,44.56939793274578,-55.43060206725422,0.2387175756655111,0.36620031094624916,-0.0007112213186070138,72499600.0,-1.0
435,ACGL,2021-11-18,39.623939514160156,40.18496978502085,39.576395313725854,40.08988138415225,1969200.0,-0.4564361572265625,0.4564361572265625,0.0,41.71877329751514,38.94880284600547,41.48770370145065,26.591690916434203,-73.4083090835658,0.17429383778195273,0.3278190163133899,-0.03897608250730511,70530400.0,-1.0
436,ACGL,2021-11-19,39.99479293823242,40.08988133899391,39.224563833460444,39.69050570292769,1727900.0,0.3708534240722656,0.0,0.3708534240722656,48.10779151842052,38.94880284600547,41.48770370145065,41.19854030469987,-58.80145969530014,0.15141689363642996,0.2925385917779979,-0.013139323306777362,72258300.0,1.0
437,ACGL,2021-11-22,40.99323654174805,41.35457900175312,39.97577539657249,40.10890061147171,1489000.0,0.998443603515625,0.0,0.998443603515625,61.29021715464328,38.94880284600547,41.48770370145065,80.52436121551897,-19.475638784481024,0.21141573604062103,0.2763140206305225,0.025940042144560804,73747300.0,1.0
438,ACGL,2021-11-23,41.59230422973633,41.68739263390988,41.09783654777563,41.10734393723694,1145000.0,0.5990676879882812,0.0,0.5990676879882812,67.07989785636659,38.94880284600547,41.68739263390988,96.52783324492295,-3.472166755077051,0.3038029553587407,0.28181180757616614,0.04741386639445677,74892300.0,1.0
439,ACGL,2021-11-24,41.63984680175781,41.7729720133454,41.38310376767175,41.582791585053144,1333800.0,0.047542572021484375,0.0,0.047542572021484375,67.52467460293323,38.94880284600547,41.7729720133454,95.2862168057383,-4.7137831942616835,0.3765165323036115,0.30075275252165523,0.055944072179608506,76226100.0,1.0
440,ACGL,2021-11-26,39.83313751220703,40.57483718009396,39.72853809701479,40.57483718009396,1319200.0,-1.8067092895507812,1.8067092895507812,0.0,42.40363898353493,38.94880284600547,41.7729720133454,31.3130911713235,-68.6869088286765,0.2850701147058956,0.2976162249585033,-0.003093821674585606,74906900.0,-1.0
441,ACGL,2021-11-29,39.68099594116211,40.2135004334786,39.60492594362552,40.18497101043605,1487100.0,-0.15214157104492188,0.15214157104492188,0.0,40.92431274635259,38.94880284600547,41.7729720133454,25.92596447918476,-74.07403552081524,0.1980387492145823,0.2777007298097191,-0.0148725606171769,73419800.0,-1.0
442,ACGL,2021-11-30,38.39728546142578,39.557379255915436,38.26416024135239,39.26260301929299,3123500.0,-1.2837104797363281,1.2837104797363281,0.0,30.548576805260126,38.26416024135239,41.7729720133454,3.794025690861533,-96.20597430913847,0.02519067531262209,0.2271987189102997,-0.05411093014138313,70296300.0,-1.0
443,ACGL,2021-12-01,38.73009490966797,40.02331743135009,38.72058752085701,39.062911556289315,2174600.0,0.3328094482421875,0.0,0.3328094482421875,35.4446324084214,38.26416024135239,41.7729720133454,13.278987263854411,-86.72101273614558,-0.08396977617886137,0.16496501989246748,-0.033689323992108,72470900.0,1.0
444,ACGL,2021-12-02,40.2135009765625,40.45122561658372,38.863223134999124,38.863223134999124,1566500.0,1.4834060668945312,0.0,1.4834060668945312,52.621930802393116,38.26416024135239,41.7729720133454,55.55558011887538,-44.444419881124624,-0.0502030388067638,0.12193140815262123,0.01487892091576759,74037400.0,1.0
445,ACGL,2021-12-03,40.17546463012695,40.75551333889701,39.899703173926405,40.24202723991465,1530800.0,-0.038036346435546875,0.038036346435546875,0.0,52.21090379138873,38.26416024135239,41.7729720133454,54.47155655456939,-45.52844344543062,-0.026209741848482793,0.09230317815240043,0.004517380354326583,72506600.0,-1.0
446,ACGL,2021-12-06,41.02176284790039,41.43064951440503,40.69845719595231,40.69845719595231,1546500.0,0.8462982177734375,0.0,0.8462982177734375,60.193284964190084,38.26416024135239,41.7729720133454,78.59078188687437,-21.40921811312563,0.06039808074005748,0.08592215866993184,0.0006958783584529726,74053100.0,1.0
447,ACGL,2021-12-07,41.230960845947266,41.58279228641872,41.107343021363775,41.192924034169266,1505700.0,0.209197998046875,0.0,0.209197998046875,62.00349632301388,38.26416024135239,41.7729720133454,84.55285713173855,-15.44714286826146,0.14425307456969705,0.0975883418498849,-0.008687746218463244,75558800.0,1.0
448,ACGL,2021-12-08,41.25948715209961,41.53524859982049,41.05028831211962,41.29752396434871,1058800.0,0.02852630615234375,0.0,0.02852630615234375,62.27342945618114,38.26416024135239,41.7729720133454,85.36584762555864,-14.634152374441358,0.210583124647016,0.12018729840931112,-0.009134511264391687,76617600.0,1.0
449,ACGL,2021-12-09,41.3355598449707,41.67788389271713,40.888636379591766,40.888636379591766,1307700.0,0.07607269287109375,0.0,0.07607269287109375,63.08047823427914,38.26416024135239,41.7729720133454,87.53389475417063,-12.466105245829375,0.26621978183523964,0.14939379509449685,0.03771790088850646,77925300.0,1.0
450,ACGL,2021-12-10,41.297523498535156,41.67788436195577,41.09783567756485,41.4591745076854,1177000.0,-0.038036346435546875,0.038036346435546875,0.0,62.311457102178146,38.26416024135239,41.7729720133454,86.44987118986464,-13.550128810135368,0.3037416732860194,0.18026337073280138,0.04073807925007711,76748300.0,-1.0
451,ACGL,2021-12-13,41.22145080566406,41.706411098845116,40.92667457587765,41.26899863520778,1454100.0,-0.07607269287109375,0.07607269287109375,0.0,60.60639710155363,38.26416024135239,41.7729720133454,84.28182406125265,-15.718175938747352,0.32360924609350405,0.20893254580494192,0.07355117192009475,75294200.0,-1.0
452,ACGL,2021-12-14,41.601810455322266,41.8300276973002,41.12636119297572,41.30703060680701,1356900.0,0.3803596496582031,0.0,0.3803596496582031,65.9773725209941,38.26416024135239,41.8300276973002,93.59995163035927,-6.400048369640729,0.3658292339229021,0.24031188342853396,0.07414687602372605,76651100.0,1.0
453,ACGL,2021-12-15,41.78247833251953,42.067750781347996,41.088322870309334,41.63984573549517,2158300.0,0.18066787719726562,0.0,0.18066787719726562,68.34292535371455,38.26416024135239,42.067750781347996,92.4999169645428,-7.500083035457196,0.40915083015912046,0.2740796727746513,0.03901618406394092,78809400.0,1.0
454,ACGL,2021-12-16,41.92511749267578,42.34351155159046,41.83002908800112,42.21038633408988,1704900.0,0.14263916015625,0.0,0.14263916015625,70.22861239777961,38.26416024135239,42.34351155159046,89.74361296452642,-10.256387035473576,0.44980818665114697,0.30922537554995044,0.04355028320535692,80514300.0,1.0
455,ACGL,2021-12-17,41.097835540771484,41.94413465030593,40.73649308446363,41.83953523184391,3558300.0,-0.8272819519042969,0.8272819519042969,0.0,50.212709776465815,38.26416024135239,42.34351155159046,69.46387020670012,-30.53612979329988,0.41054221980038363,0.3294887444000371,0.0018544471907058213,76956000.0,-1.0
456,ACGL,2021-12-20,40.34662628173828,40.698457734060376,39.87117700066891,40.59385831184269,1774800.0,-0.7512092590332031,0.7512092590332031,0.0,38.66625842119102,38.72058752085701,42.34351155159046,44.88194472441326,-55.11805527558674,0.3151742169055254,0.3266258389011348,-0.021448313259377016,75181200.0,-1.0
457,ACGL,2021-12-21,40.82207489013672,41.39261256706252,40.41318822496353,40.489261849828345,1456200.0,0.4754486083984375,0.0,0.4754486083984375,47.485037896934834,38.863223134999124,42.34351155159046,56.2841787996448,-43.715821200355194,0.2747914914680578,0.3162589694145194,-0.01060149536882049,76637400.0,1.0
458,ACGL,2021-12-22,41.17390441894531,41.24997804026693,40.755510383846186,40.82207298880764,936400.0,0.35182952880859375,0.0,0.35182952880859375,53.227241889208585,39.87117700066891,42.34351155159046,52.692198059959914,-47.307801940040086,0.2680872502870457,0.3066246255890247,-0.003910807707254493,77573800.0,1.0
459,ACGL,2021-12-23,41.34506607055664,41.61131648802638,41.23095926698245,41.297521871349886,780200.0,0.17116165161132812,0.0,0.17116165161132812,55.93207368816976,39.87117700066891,42.34351155159046,59.615276150161264,-40.38472384983873,0.273433435242012,0.2999863875196222,0.0011512208964097326,78354000.0,1.0
460,ACGL,2021-12-27,41.772972106933594,41.782479496044026,40.98372459733896,41.192923431668135,704900.0,0.4279060363769531,0.0,0.4279060363769531,62.2323189235811,39.87117700066891,42.34351155159046,76.92304852334001,-23.076951476659985,0.3086409456129573,0.30171729913828926,0.013379473320083823,79058900.0,1.0
461,ACGL,2021-12-28,42.09627914428711,42.210385954348176,41.83953610110714,41.83953610110714,684800.0,0.3233070373535156,0.0,0.3233070373535156,66.41791356886193,39.87117700066891,42.34351155159046,90.0000423805429,-9.999957619457112,0.35849877642622374,0.3130735945958762,0.011885749287182445,79743700.0,1.0
462,ACGL,2021-12-29,42.410072326660156,42.60025275517678,42.04873350260752,42.05824089170787,518300.0,0.3137931823730469,0.0,0.3137931823730469,70.1256705791703,39.87117700066891,42.60025275517678,93.03132468190056,-6.968675318099443,0.41850765811963697,0.3341604073006284,0.015020506661812094,80262000.0,1.0
463,ACGL,2021-12-30,42.1533317565918,42.7143583827819,42.10578393023208,42.12480233529799,530200.0,-0.2567405700683594,0.2567405700683594,0.0,63.506263984788845,39.87117700066891,42.7143583827819,80.26764561277614,-19.73235438722388,0.4402731164424196,0.35538294912898666,0.005443378040762337,79731800.0,-1.0
464,ACGL,2021-12-31,42.26744079589844,42.552709632200546,42.02971616108168,42.02971616108168,777500.0,0.11410903930664062,0.0,0.11410903930664062,65.19127817250349,39.87117700066891,42.7143583827819,84.28107366997017,-15.718926330029822,0.4614111838885222,0.3765885960808938,0.028459047532238824,80509300.0,1.0
465,ACGL,2022-01-03,42.36252975463867,42.48614758203439,41.868062072445895,42.314985552529585,1550400.0,0.09508895874023438,0.0,0.09508895874023438,66.67095233267312,39.87117700066891,42.7143583827819,87.62552996595106,-12.374470034048938,0.48029954473425107,0.3973307858115653,0.04996461064237301,82059700.0,1.0
466,ACGL,2022-01-04,42.9140510559082,43.303919302492154,42.799940622232434,42.86650685557162,968600.0,0.5515213012695312,0.0,0.5515213012695312,74.05258218813236,39.87117700066891,43.303919302492154,88.64265906657546,-11.35734093342454,0.5336206202020151,0.42458875268965524,0.051246198812813004,83028300.0,1.0
467,ACGL,2022-01-05,42.410072326660156,44.28334356235552,42.30547653699647,44.28334356235552,1217700.0,-0.5039787292480469,0.5039787292480469,0.0,60.0334669015336,39.87117700066891,44.28334356235552,57.543052613605795,-42.456947386394205,0.5291118135179218,0.44549336485530855,0.03002309169266071,81810600.0,-1.0
468,ACGL,2022-01-06,42.65730667114258,43.44655052844268,42.562214646089046,43.14226330305109,1651200.0,0.24723434448242188,0.0,0.24723434448242188,63.90169206536921,39.87117700066891,44.28334356235552,63.14652068367595,-36.85347931632404,0.5392719062623925,0.4642490731367253,0.031738747214638874,83461800.0,1.0
469,ACGL,2022-01-07,42.85699462890625,43.04717505227239,42.56221479131924,42.90453882790032,1880200.0,0.19968795776367188,0.0,0.19968795776367188,66.88836001781486,39.87117700066891,44.28334356235552,67.67236881229553,-32.32763118770447,0.5570160677924818,0.48280247206787663,0.02595033265044422,85342000.0,1.0
470,ACGL,2022-01-10,43.76034927368164,43.78887506783108,42.79993976023163,43.12324539435492,2341900.0,0.9033546447753906,0.0,0.9033546447753906,76.87526911934113,40.41318822496353,44.28334356235552,86.48647811055791,-13.513521889442092,0.6366329059785585,0.5135685588500131,0.03953010012335878,87683900.0,1.0
471,ACGL,2022-01-11,44.093162536621094,44.1407067362588,43.35146286558111,43.87445631637571,1370900.0,0.3328132629394531,0.0,0.3328132629394531,79.50326854841441,40.755510383846186,44.28334356235552,94.60912644926184,-5.390873550738166,0.7183049009630764,0.5545158272726257,0.03968609619425001,89054800.0,1.0
472,ACGL,2022-01-12,44.188255310058594,44.40696153400006,43.86494966871251,44.302362116595454,2037700.0,0.0950927734375,0.0,0.0950927734375,80.24347675351781,40.98372459733896,44.40696153400006,93.61112806422376,-6.388871935776241,0.7816928686928151,0.5999512355566636,0.048274323017149845,91092500.0,1.0
473,ACGL,2022-01-13,44.44499969482422,45.21522519657239,44.26432664931581,44.321381868011635,1407300.0,0.256744384765625,0.0,0.256744384765625,82.24140229757376,40.98372459733896,45.21522519657239,81.79781655028704,-18.202183449712965,0.8429286590755751,0.648546720260446,0.05151858872745119,92499800.0,1.0
474,ACGL,2022-01-14,45.08209991455078,45.15817353936754,43.81740673478794,44.37843339455613,1710600.0,0.6371002197265625,0.0,0.6371002197265625,86.22884071600649,41.83953610110714,45.21522519657239,96.05635239926438,-3.9436476007356247,0.9321222028684346,0.7052618167820438,0.06419753909088288,94210400.0,1.0
475,ACGL,2022-01-18,44.302364349365234,45.2437555260614,44.23580173991492,45.234244509059835,1591400.0,-0.7797355651855469,0.7797355651855469,0.0,65.46956232292432,41.868062072445895,45.2437555260614,72.11265804695931,-27.88734195304069,0.9291795815190582,0.7500453697294468,0.03235101928849238,92619000.0,-1.0
476,ACGL,2022-01-19,43.665260314941406,44.51156308385503,43.646245535765956,44.36892684830809,1205900.0,-0.6371040344238281,0.6371040344238281,0.0,53.35868188367098,41.868062072445895,45.2437555260614,53.23937932132551,-46.7606206786745,0.8654620539947828,0.7731287065825141,0.02959645950644152,91413100.0,-1.0
477,ACGL,2022-01-20,43.38949966430664,44.4069607713112,43.35146285365098,43.912493114957314,1731400.0,-0.2757606506347656,0.2757606506347656,0.0,48.84599608723014,41.868062072445895,45.2437555260614,45.07037184407917,-54.92962815592083,0.7836800981459859,0.7752389848952086,0.017164538746169633,89681700.0,-1.0
478,ACGL,2022-01-21,42.97110366821289,43.56066337406796,42.83797845314564,43.265883521140424,1337200.0,-0.41839599609375,0.41839599609375,0.0,42.546611638370905,41.868062072445895,45.2437555260614,32.676000084829795,-67.3239999151702,0.6772987701071571,0.7556509419375984,0.0026625534593522904,88344500.0,-1.0
479,ACGL,2022-01-24,43.45606231689453,43.513113905550654,41.6588647264284,42.65730742919959,2056600.0,0.4849586486816406,0.0,0.4849586486816406,50.99833172853228,41.6588647264284,45.2437555260614,50.13256165711154,-49.867438342888455,0.6249192312808844,0.7295045998062557,-0.0069534855602744194,90401100.0,1.0
480,ACGL,2022-01-25,43.028160095214844,43.37048415922771,41.83002949855997,43.047178501814464,1703900.0,-0.4279022216796875,0.4279022216796875,0.0,44.355347997302204,41.6588647264284,45.2437555260614,38.196292309004946,-61.803707690995054,0.542624894217127,0.69212865868843,-0.024153460086282608,88697200.0,-1.0
481,ACGL,2022-01-26,42.8189582824707,43.6652573668558,42.238909617247685,43.227844927549555,1647800.0,-0.20920181274414062,0.20920181274414062,0.0,41.319167470422904,41.6588647264284,45.2437555260614,32.360638604698046,-67.63936139530196,0.45527705083753744,0.6447583371182515,-0.030987804745397973,87049400.0,-1.0
482,ACGL,2022-01-27,42.581233978271484,43.90298232248178,42.19136573553759,43.189808442305875,1926400.0,-0.23772430419921875,0.23772430419921875,0.0,37.91616652427281,41.6588647264284,45.2437555260614,25.729354208990497,-74.2706457910095,0.3626900261927517,0.5883446749331516,-0.04193420473281673,85123000.0,-1.0
483,ACGL,2022-01-28,43.15177536010742,43.256374776494404,42.10578482362758,42.55270828368469,2416900.0,0.5705413818359375,0.0,0.5705413818359375,49.44609659161799,41.6588647264284,45.2437555260614,41.644521887022584,-58.35547811297742,0.331530387472867,0.5369818174410946,-0.04281798226129929,87539900.0,1.0
484,ACGL,2022-01-31,44.04561996459961,44.102675182707166,42.79043418535377,42.86650780949718,1762200.0,0.8938446044921875,0.0,0.8938446044921875,62.15218209327536,41.6588647264284,45.2437555260614,66.57818526621655,-33.42181473378345,0.3746432841336116,0.5045141107795981,-0.005795275004759515,89302100.0,1.0
485,ACGL,2022-02-01,44.996517181396484,45.04406138139566,43.86494926090037,44.08365548280853,2109000.0,0.950897216796875,0.0,0.950897216796875,71.07575177273594,41.6588647264284,45.2437555260614,93.10332284904675,-6.8966771509532565,0.48000680412074814,0.49961264944782807,0.030487780373990914,91411100.0,1.0
486,ACGL,2022-02-02,45.58607482910156,45.63362265814645,44.692231504864694,44.99651874832363,1818800.0,0.5895576477050781,0.0,0.5895576477050781,75.25029044139524,41.6588647264284,45.63362265814645,98.80375535160363,-1.1962446483963747,0.604116647185478,0.5205134489953581,0.05062457925971153,93229900.0,1.0
487,ACGL,2022-02-03,45.443443298339844,45.833311564949284,45.29129967301397,45.538531703897206,1015400.0,-0.14263153076171875,0.14263153076171875,0.0,72.33596620753676,41.6588647264284,45.833311564949284,90.66060051329865,-9.339399486701346,0.6830911696718971,0.5530289931306659,0.05753493438791568,92214500.0,-1.0
488,ACGL,2022-02-04,45.300804138183594,45.69067237962477,44.63517446008184,45.129642117317715,1180000.0,-0.14263916015625,0.14263916015625,0.0,69.24162585598003,41.6588647264284,45.833311564949284,87.24364095736404,-12.756359042635964,0.7258026583348567,0.5875837261715041,0.0424507358222348,91034500.0,-1.0
489,ACGL,2022-02-07,45.25326156616211,45.728710835137385,45.15817316332308,45.376879391764895,1536400.0,-0.047542572021484375,0.047542572021484375,0.0,68.12093405426131,41.6588647264284,45.833311564949284,86.10474582082111,-13.895254179178892,0.7472022501649747,0.6195074309701982,0.05171267992922424,89498100.0,-1.0
490,ACGL,2022-02-08,45.833309173583984,46.032996991269776,45.177186876345004,45.46245933291324,1352500.0,0.580047607421875,0.0,0.580047607421875,74.03666361151596,41.6588647264284,46.032996991269776,95.4348015653104,-4.565198434689613,0.8017247907930027,0.6559509029347592,0.07039757649469247,90850600.0,1.0
491,ACGL,2022-02-09,45.89036178588867,46.28974105755244,45.72871077579408,45.92839859793094,1590300.0,0.0570526123046875,0.0,0.0570526123046875,74.57217865631961,41.6588647264284,46.28974105755244,91.37573014032901,-8.62426985967099,0.8398566217162724,0.6927320466910619,0.07771329053793474,92440900.0,1.0
492,ACGL,2022-02-10,45.063079833984375,46.73666324386855,44.72075578980852,46.099559355565724,3039700.0,-0.8272819519042969,0.8272819519042969,0.0,55.440134535380814,41.6588647264284,46.73666324386855,67.0411615558179,-32.958838444182106,0.7941669703308278,0.7130190314190151,0.04429260344277508,89401200.0,-1.0
493,ACGL,2022-02-11,44.27383804321289,45.291299207252074,44.09316499616567,45.21522558167638,2743300.0,-0.7892417907714844,0.7892417907714844,0.0,43.23101370468254,41.83002949855997,46.73666324386855,49.806214841071814,-50.193785158928186,0.6863604399777756,0.7076873131307673,0.005181402345947328,86657900.0,-1.0
494,ACGL,2022-02-14,44.140708923339844,44.69223182315582,43.77937008627775,44.15972732961523,2310900.0,-0.13312911987304688,0.13312911987304688,0.0,41.454209204628235,42.10578482362758,46.73666324386855,43.942507555756045,-56.05749244424396,0.5834548759793634,0.6828408257004865,-0.01901943331761835,84347000.0,-1.0
495,ACGL,2022-02-15,45.33884048461914,45.4244214941757,44.27383518699638,44.39744937949705,1482400.0,1.1981315612792969,0.0,1.1981315612792969,58.967042144186614,42.10578482362758,46.73666324386855,69.81517041907847,-30.18482958092154,0.5917592466697883,0.664624509894347,-0.005423461998193102,85829400.0,1.0
496,ACGL,2022-02-16,45.31031799316406,45.63362364978854,45.063082335362324,45.10111914846877,1634100.0,-0.028522491455078125,0.028522491455078125,0.0,58.48648272982927,42.10578482362758,46.73666324386855,69.1992507410664,-30.800749258933603,0.5892465264203466,0.6495489131995469,-0.00292947222994977,84195300.0,-1.0
497,ACGL,2022-02-17,44.66370391845703,45.04406114383438,44.254817271318686,44.73977391257653,1414500.0,-0.6466140747070312,0.6466140747070312,0.0,48.20929814993594,42.79043418535377,46.73666324386855,47.46986820395812,-52.53013179604188,0.528981061274834,0.6254353428146043,-0.014063772858936008,82780800.0,-1.0
498,ACGL,2022-02-18,44.78731918334961,45.205716856876975,44.44499876054087,44.49254296142625,1121900.0,0.12361526489257812,0.0,0.12361526489257812,50.141843635082374,43.77937008627775,46.73666324386855,34.08350283043967,-65.91649716956033,0.4855973013229189,0.5974677345162673,-0.010296327086419477,83902700.0,1.0
499,ACGL,2022-02-22,44.53057861328125,44.99651684816852,44.15972515029823,44.568611796564966,1359100.0,-0.2567405700683594,0.2567405700683594,0.0,46.02606439028672,43.77937008627775,46.73666324386855,25.401895820686306,-74.5981041793137,0.42559257438848874,0.5630927024907116,-0.028423227207289736,82543600.0,-1.0
500,ACGL,2022-02-23,44.017093658447266,44.967992184864926,43.96954945760439,44.74928595907567,2171800.0,-0.5134849548339844,0.5134849548339844,0.0,38.69612504164499,43.77937008627775,46.73666324386855,8.038552808311348,-91.96144719168865,0.3327685033347194,0.5170278626595132,-0.04082051338321413,80371800.0,-1.0
501,ACGL,2022-02-24,43.67477035522461,43.88396919537779,42.50516558302195,42.790434420346244,3085800.0,-0.34232330322265625,0.34232330322265625,0.0,34.473014493781164,42.50516558302195,46.73666324386855,27.64044473012084,-72.35955526987917,0.22894301603170675,0.45941089333395185,-0.030808135703871087,77286000.0,-1.0
502,ACGL,2022-02-25,45.20571517944336,45.23424097343809,43.95052946021705,43.95052946021705,1577700.0,1.53094482421875,0.0,1.53094482421875,58.08058053434426,42.50516558302195,46.73666324386855,63.82018407830359,-36.17981592169641,0.2671158764467165,0.4209518899565048,0.021048031465465522,78863700.0,1.0
503,ACGL,2022-02-28,44.79682922363281,45.14866065538462,44.33088735937507,44.49254199173018,3071300.0,-0.4088859558105469,0.4088859558105469,0.0,52.27656424401676,42.50516558302195,46.73666324386855,54.15727064711099,-45.84272935288901,0.26136164951123675,0.38903384186745116,0.014864290046461726,75792400.0,-1.0
504,ACGL,2022-03-01,43.579681396484375,44.81584876072792,43.37048255899746,44.540087316293345,2259800.0,-1.2171478271484375,1.2171478271484375,0.0,38.91851647464805,42.50516558302195,46.73666324386855,25.39327442869121,-74.6067255713088,0.15678045815664632,0.34258316512529025,-0.03880026637936507,73532600.0,-1.0
505,ACGL,2022-03-02,44.806339263916016,44.939464482326926,43.87445910764949,43.99807693648397,1691800.0,1.2266578674316406,0.0,1.2266578674316406,52.9107179903175,42.50516558302195,46.73666324386855,54.38201472226901,-45.61798527773099,0.17091000468926154,0.3082485330380845,-0.011122824812751952,75224400.0,1.0
506,ACGL,2022-03-03,44.27383804321289,45.12013717709687,44.207275434529215,44.93946413004965,1657200.0,-0.532501220703125,0.532501220703125,0.0,47.46455140576369,42.50516558302195,45.63362364978854,56.53495819488315,-43.46504180511685,0.13755374001127052,0.2741095744327217,-0.008728919481373998,73567200.0,-1.0
507,ACGL,2022-03-04,43.76034927368164,43.893474482898895,42.98061279621781,43.49409885524713,2086200.0,-0.51348876953125,0.51348876953125,0.0,42.58719440488427,42.50516558302195,45.63362364978854,40.12148041853038,-59.87851958146961,0.06889028333500136,0.23306571621317765,-0.022929925889597857,71481000.0,-1.0
508,ACGL,2022-03-07,42.09627914428711,43.61771536973497,42.08676812747113,43.24686551649393,3284400.0,-1.6640701293945312,1.6640701293945312,0.0,30.76573605498686,42.08676812747113,45.63362364978854,0.26815348852336557,-99.73184651147663,-0.1184372817429562,0.16276511662195087,-0.05466579471455846,68196600.0,-1.0
509,ACGL,2022-03-08,41.906097412109375,43.1707941826203,41.44966655860325,42.44810927735978,2643900.0,-0.19018173217773438,0.19018173217773438,0.0,29.67933236031682,41.44966655860325,45.63362364978854,10.909071091281744,-89.09092890871825,-0.2790253722570313,0.07440701884615442,-0.04795855589008824,65552700.0,-1.0
510,ACGL,2022-03-09,43.32293701171875,43.74133104630126,42.82846935590855,42.952083549318665,2178500.0,1.416839599609375,0.0,1.416839599609375,46.0543029274239,41.44966655860325,45.23424097343809,49.497519345177174,-50.502480654822826,-0.2886382344031233,0.0017979681962988498,-0.008055757148675458,67731200.0,1.0
511,ACGL,2022-03-10,42.980613708496094,43.56066238444577,42.52418285546765,42.68583386226545,1909000.0,-0.34232330322265625,0.34232330322265625,0.0,43.24683043020475,41.44966655860325,45.23424097343809,40.452293496775006,-59.547706503224994,-0.3201881963484112,-0.06259926471264318,-0.04922168495984991,65822200.0,-1.0
512,ACGL,2022-03-11,43.484588623046875,43.96003788019026,43.22784558890265,43.246863994475184,1636600.0,0.5039749145507812,0.0,0.5039749145507812,48.57235393710701,41.44966655860325,45.23424097343809,53.768847996939975,-46.231152003060025,-0.30105483208100736,-0.11029037818631604,-0.02929315809462818,67458800.0,1.0
513,ACGL,2022-03-14,44.05513000488281,44.540086652183376,43.731824364219115,43.826912764900804,1589900.0,0.5705413818359375,0.0,0.5705413818359375,54.18774481902578,41.44966655860325,45.23424097343809,68.84429160823532,-31.15570839176468,-0.23712020759877106,-0.13565634406880706,0.010909868846282755,69048700.0,1.0
514,ACGL,2022-03-15,44.51156234741211,44.83486799889796,44.2928561166114,44.2928561166114,2103300.0,0.4564323425292969,0.0,0.4564323425292969,58.382411230694096,41.44966655860325,45.23424097343809,80.90462633808407,-19.095373661915925,-0.14791619576449477,-0.1381083144079446,-0.00657891096096086,71152000.0,1.0
515,ACGL,2022-03-16,44.35941696166992,44.83486621687586,43.74133147894622,44.68272260030556,1719200.0,-0.1521453857421875,0.1521453857421875,0.0,56.396330552155725,41.44966655860325,45.23424097343809,76.88448116282196,-23.115518837178044,-0.08847831189924449,-0.12818231390620458,0.0019329455551946317,69432800.0,-1.0
516,ACGL,2022-03-17,44.21678161621094,44.30236262895082,43.72231394564608,43.9600385779913,1194700.0,-0.14263534545898438,0.14263534545898438,0.0,54.39468309549436,41.44966655860325,45.14866065538462,74.80723097167032,-25.19276902832967,-0.052280187575341586,-0.11300188864003197,0.010430271926641144,68238100.0,-1.0
517,ACGL,2022-03-18,43.58918762207031,44.04561846926493,43.52262501689963,44.04561846926493,3591400.0,-0.627593994140625,0.627593994140625,0.0,46.08967735557918,41.44966655860325,45.12013717709687,58.29010189285027,-41.70989810714974,-0.07338852631198023,-0.1050792161744216,0.03546414334307757,64646700.0,-1.0
518,ACGL,2022-03-21,44.83486557006836,44.87289875311979,43.93151127273128,44.0265996714447,2119500.0,1.2456779479980469,0.0,1.2456779479980469,60.05666414129002,41.44966655860325,45.12013717709687,92.22792833182821,-7.772071668171784,0.01028025857866055,-0.08200732122380516,0.06988883095357568,66766200.0,1.0
519,ACGL,2022-03-22,44.79682922363281,45.42442209285573,44.49254199173018,45.16767906080227,1598200.0,-0.038036346435546875,0.038036346435546875,0.0,59.51343044575063,41.44966655860325,45.42442209285573,84.2105290799741,-15.789470920025908,0.0726813329673135,-0.051069590385581426,0.03402105936435884,65168000.0,-1.0
520,ACGL,2022-03-23,44.31187057495117,44.70173883180024,44.30236318558951,44.644687240850175,1630600.0,-0.4849586486816406,0.4849586486816406,0.0,52.52406645307907,41.44966655860325,45.42442209285573,72.00956113358075,-27.990438866419247,0.08205662630611954,-0.02444434704724123,0.030973426193584785,63537400.0,-1.0
521,ACGL,2022-03-24,44.81584930419922,44.86339350582552,44.34990742252527,44.50205104416349,2235100.0,0.5039787292480469,0.0,0.5039787292480469,58.38454080978707,41.44966655860325,45.42442209285573,84.68905110233497,-15.31094889766502,0.12867025474456995,0.006178573311121013,0.03061454007746489,65772500.0,1.0
522,ACGL,2022-03-25,45.32933044433594,45.41491145573515,44.92995480939957,44.92995480939957,2332800.0,0.5134811401367188,0.0,0.5134811401367188,63.658346626696336,41.44966655860325,45.42442209285573,97.60761013601117,-2.3923898639888144,0.20468603458908063,0.04588006556671295,0.028922861862214377,68105300.0,1.0
523,ACGL,2022-03-28,45.26276779174805,45.329330397502005,44.83486636258403,45.300804602861724,1261900.0,-0.06656265258789062,0.06656265258789062,0.0,62.474149971047424,42.52418285546765,45.42442209285573,94.42617357134768,-5.573826428652328,0.2566001116444099,0.08802407478225235,0.016876636197866723,66843400.0,-1.0
524,ACGL,2022-03-29,46.17563247680664,46.19465088209794,45.405403385763684,45.54803961175346,1774000.0,0.9128646850585938,0.0,0.9128646850585938,71.00838466212645,42.52418285546765,46.19465088209794,99.48185339980313,-0.518146600196878,0.367170430519856,0.1438533459297731,0.040943178236676925,68617400.0,1.0
525,ACGL,2022-03-30,46.0615234375,46.508446906881225,45.833309821885344,46.18514126193545,2160700.0,-0.11410903930664062,0.11410903930664062,0.0,68.7531678221549,43.22784558890265,46.508446906881225,86.37678199627716,-13.623218003722833,0.44051260393319325,0.20318519753045716,0.041720400125474955,66456700.0,-1.0
526,ACGL,2022-03-31,46.042503356933594,46.67009984552143,46.032995968041305,46.356301601227514,2377300.0,-0.01902008056640625,0.01902008056640625,0.0,68.33575395497692,43.52262501689963,46.67009984552143,80.06031746844364,-19.939682531556365,0.49143706267130227,0.2608355705586262,0.05628266707180174,64079400.0,-1.0
527,ACGL,2022-04-01,46.23268508911133,46.40384711313347,45.68116583300997,46.071034081640406,2152000.0,0.19018173217773438,0.0,0.19018173217773438,70.40849731481369,43.52262501689963,46.67009984552143,86.10267658275022,-13.897323417249785,0.5409059128230709,0.3168496390115152,0.031177065020044248,66231400.0,1.0
528,ACGL,2022-04-04,44.76830291748047,46.07103284088472,44.711247701879664,45.91888922667247,1684900.0,-1.4643821716308594,1.4643821716308594,0.0,44.51780495529898,43.52262501689963,46.67009984552143,39.577056796552355,-60.422943203447645,0.45668257759452047,0.3448162267281163,-0.0006367929750102919,64546500.0,-1.0
529,ACGL,2022-04-05,45.158172607421875,45.51000404646329,44.73977493434451,44.76830435675706,1509400.0,0.38986968994140625,0.0,0.38986968994140625,50.14905638683934,43.52262501689963,46.67009984552143,51.963802081887046,-48.03619791811296,0.4165919901874844,0.35917137941998994,0.019098765669105067,66055900.0,1.0
530,ACGL,2022-04-06,44.977500915527344,45.510005412063535,44.711250480954305,44.996519321909716,1590000.0,-0.18067169189453125,0.18067169189453125,0.0,47.567508226310885,43.52262501689963,46.67009984552143,46.223591222960394,-53.776408777039606,0.3660219421227211,0.3605414919605362,0.0036070188078076715,64465900.0,-1.0
531,ACGL,2022-04-07,45.03455352783203,45.224733953257015,44.27383545352201,44.834865713461255,1060500.0,0.0570526123046875,0.0,0.0570526123046875,48.53284959719394,43.93151127273128,46.67009984552143,40.277764468174325,-59.722235531825675,0.32678154941113746,0.35378950345065646,-0.006503006190790583,65526400.0,1.0
532,ACGL,2022-04-08,45.947418212890625,46.08054343115124,45.14866327593681,45.46246154245695,2125400.0,0.9128646850585938,0.0,0.9128646850585938,61.58899258354843,44.27383545352201,46.67009984552143,69.84132322611508,-30.158676773884913,0.3651347602040502,0.35605855480133525,0.015126128041763165,67651800.0,1.0
533,ACGL,2022-04-11,45.662147521972656,46.73666386891955,45.62411071046887,45.96643475922293,1867900.0,-0.28527069091796875,0.28527069091796875,0.0,56.427511644127435,44.27383545352201,46.73666386891955,56.370637100455504,-43.629362899544496,0.3682658558779224,0.3585000150166527,-0.011120258181453235,65783900.0,-1.0
534,ACGL,2022-04-12,45.348350524902344,46.185142264225824,45.19620690206081,45.60509356858307,1809800.0,-0.3137969970703125,0.3137969970703125,0.0,51.002482461389015,44.27383545352201,46.73666386891955,43.62931110679464,-56.37068889320537,0.34148999254126267,0.3550980105215747,-0.015483050914834484,63974100.0,-1.0
535,ACGL,2022-04-13,45.48147964477539,45.64313065804203,44.86339413282502,45.18669978674843,1926700.0,0.13312911987304688,0.0,0.13312911987304688,53.20482292934305,44.27383545352201,46.73666386891955,49.03484886333208,-50.96515113666792,0.3272401149592099,0.3495264314091018,-0.012184908970066188,65900800.0,1.0
536,ACGL,2022-04-14,46.575008392333984,47.07898343978968,45.27227845467853,45.27227845467853,7599400.0,1.0935287475585938,0.0,1.0935287475585938,67.18443948096561,44.27383545352201,47.07898343978968,82.03392299005765,-17.966077009942357,0.3995795113601872,0.3595370473993189,0.007404356951426161,73500200.0,1.0
537,ACGL,2022-04-18,46.251705169677734,46.679610245228275,46.090054156353155,46.384830387095654,1750200.0,-0.32330322265625,0.32330322265625,0.0,60.97082931943099,44.27383545352201,47.07898343978968,70.50856945295551,-29.491430547044484,0.42591149349822643,0.37281193661910045,0.03313510129994346,71750000.0,-1.0
538,ACGL,2022-04-19,46.5179557800293,46.660592014881026,46.11858012626867,46.49894100094652,1444300.0,0.2662506103515625,0.0,0.2662506103515625,64.12373522416621,44.27383545352201,47.07898343978968,80.00006906919562,-19.999930930804393,0.4629276365290238,0.3908350766010852,0.0301115632917337,73194300.0,1.0
539,ACGL,2022-04-20,47.50688934326172,47.697069773358756,46.56550183673588,46.945859069539964,2159800.0,0.9889335632324219,0.0,0.9889335632324219,73.35027455069482,44.27383545352201,47.697069773358756,94.44442266207163,-5.555577337928379,0.565542646665385,0.42577659061394524,0.056236748957769755,75354100.0,1.0
540,ACGL,2022-04-21,46.83175277709961,48.23908217145966,46.72715335802724,47.915776524958694,1459600.0,-0.6751365661621094,0.6751365661621094,0.0,60.99391475394814,44.27383545352201,48.23908217145966,64.5084027686426,-35.491597231357396,0.585637043669081,0.45774868122497236,0.03990711816776171,73894500.0,-1.0
541,ACGL,2022-04-22,44.98701095581055,46.6605907798374,44.95848153316126,46.59402817263912,1858800.0,-1.8447418212890625,1.8447418212890625,0.0,39.83652396590783,44.27383545352201,48.23908217145966,17.985652672312497,-82.0143473276875,0.44754769895467206,0.45570848477091236,-0.020902311695298548,72035700.0,-1.0
542,ACGL,2022-04-25,44.435489654541016,44.76830632982895,43.37999166350785,44.663706906949606,2433400.0,-0.5515213012695312,0.5515213012695312,0.0,35.57911522750807,43.37999166350785,48.23908217145966,21.722130701329032,-78.27786929867096,0.29026178149647563,0.422619144116025,-0.02686377960741715,69602300.0,-1.0
543,ACGL,2022-04-26,44.226287841796875,44.53057870039125,43.94101901596644,43.94101901596644,2965000.0,-0.20920181274414062,0.20920181274414062,0.0,33.98926314445153,43.37999166350785,48.23908217145966,17.41676095359978,-82.58323904640021,0.14703578382176374,0.3675024720571728,-0.024743186248622373,66637300.0,-1.0
544,ACGL,2022-04-27,45.576568603515625,45.81429324525005,44.27383858248021,44.40696380146906,3598900.0,1.35028076171875,0.0,1.35028076171875,50.4717034352425,43.37999166350785,48.23908217145966,45.20551606135179,-54.79448393864822,0.14086076624993638,0.32217413089572555,0.002090718232627964,70236200.0,1.0
545,ACGL,2022-04-28,44.464012145996094,45.300803839445464,43.76985667812431,43.81740450491011,2535400.0,-1.1125564575195312,1.1125564575195312,0.0,40.78901362602689,43.37999166350785,48.23908217145966,22.309123090303917,-77.69087690969609,0.04566659614226154,0.26687262394503275,-0.0453246562739289,67700800.0,-1.0
546,ACGL,2022-04-29,43.42753219604492,44.65419211586258,43.31342539317975,44.17874287196952,2127000.0,-1.0364799499511719,1.0364799499511719,0.0,33.81551371875989,43.31342539317975,48.23908217145966,2.3165804683821345,-97.68341953161787,-0.11211830916489873,0.19107443732304644,-0.06106094820227992,65573800.0,-1.0
547,ACGL,2022-05-02,43.62722396850586,44.05512901675578,43.02815690095598,43.360969923267085,2164200.0,0.1996917724609375,0.0,0.1996917724609375,36.23883509037652,43.02815690095598,48.23908217145966,11.496366507899989,-88.50363349210001,-0.21853143193955304,0.10915326347052653,-0.06214227953594775,67738000.0,1.0
548,ACGL,2022-05-03,44.15021896362305,44.62566822782111,43.864950130582216,43.87445751981457,1570100.0,0.5229949951171875,0.0,0.5229949951171875,42.5909775548284,43.02815690095598,48.23908217145966,21.53287572589988,-78.46712427410012,-0.2576927515178724,0.035784060472846727,-0.0706564969005864,69308100.0,1.0
549,ACGL,2022-05-04,44.98701095581055,45.1866987774054,43.979057203766516,44.083656622903824,1915000.0,0.8367919921875,0.0,0.8367919921875,51.50942418095639,43.02815690095598,48.23908217145966,37.591290474699704,-62.408709525300296,-0.21868538997006226,-0.015109829615735088,-0.03939083446373004,71223100.0,1.0
550,ACGL,2022-05-05,44.16923904418945,44.69223252915903,43.80789657402914,44.21678324693393,1975200.0,-0.8177719116210938,0.8177719116210938,0.0,43.83128696581851,43.02815690095598,48.23908217145966,21.897879627876154,-78.10212037212384,-0.25086729179302836,-0.06226132205119376,-0.018177956131034567,69247900.0,-1.0
551,ACGL,2022-05-06,44.254817962646484,44.54008679298331,43.76035029728066,43.78887609209735,1868700.0,0.08557891845703125,0.0,0.08557891845703125,44.82440015175916,43.02815690095598,48.23908217145966,23.540177569499857,-76.45982243050014,-0.2663953377113941,-0.10308812518323383,-0.004065932282937501,71116600.0,1.0
552,ACGL,2022-05-09,42.9996337890625,44.25481959063053,42.9235601635662,43.85544031155519,2179300.0,-1.2551841735839844,1.2551841735839844,0.0,34.500967719600695,42.9235601635662,48.23908217145966,1.4311600136982081,-98.5688399863018,-0.3756539933725236,-0.1576012988210918,-0.02773585830043601,68937300.0,-1.0
553,ACGL,2022-05-10,43.54164505004883,43.8269138867862,42.9996331720308,43.18030258890679,2856200.0,0.5420112609863281,0.0,0.5420112609863281,41.243378535303556,42.9235601635662,48.23908217145966,11.627924511737179,-88.37207548826282,-0.413737181479938,-0.20882847535286106,-0.04464845897393488,71793500.0,1.0
554,ACGL,2022-05-11,43.484588623046875,44.41646873176111,43.418026017238,43.418026017238,2380900.0,-0.057056427001953125,0.057056427001953125,0.0,40.734068440046606,42.9235601635662,46.6605907798374,15.01268030927901,-84.98731969072098,-0.44341099333087186,-0.25574497894846326,-0.022027331220882962,69412600.0,-1.0
555,ACGL,2022-05-12,43.01865005493164,43.64624292448814,42.60025239030069,43.42753307576381,3126600.0,-0.4659385681152344,0.4659385681152344,0.0,36.48832301737007,42.60025239030069,45.81429324525005,13.01780790952466,-86.98219209047534,-0.4987754782109519,-0.304351078800961,-0.009415274606612845,66286000.0,-1.0
556,ACGL,2022-05-13,43.76034927368164,44.12169171826411,43.066193806056035,43.075701194975885,2431800.0,0.74169921875,0.0,0.74169921875,46.693556339838956,42.60025239030069,45.81429324525005,36.0946526735806,-63.9053473264194,-0.4773012711003517,-0.3389411172608392,0.0030514273672761494,68717800.0,1.0
557,ACGL,2022-05-16,43.84593200683594,44.16923765366639,43.617714762500896,43.874457802106555,1579700.0,0.08558273315429688,0.0,0.08558273315429688,47.810065642765636,42.60025239030069,45.81429324525005,38.75742944017043,-61.242570559829566,-0.44821030651876725,-0.3607949551124249,-0.006892082619971207,70297500.0,1.0
558,ACGL,2022-05-17,44.578125,44.5876323894399,43.97905789836387,43.97905789836387,2034300.0,0.7321929931640625,0.0,0.7321929931640625,56.752076963165884,42.60025239030069,45.300803839445464,73.23958261656796,-26.76041738343204,-0.3619018726310017,-0.3610163386161403,-0.009088978065517228,72331800.0,1.0
559,ACGL,2022-05-18,43.57017135620117,44.60665092282815,43.45606454564676,44.40696309751041,1672400.0,-1.0079536437988281,1.0079536437988281,0.0,44.61108551641483,42.60025239030069,45.1866987774054,37.50006072951001,-62.49993927048999,-0.3705636253851523,-0.36292579596994273,-0.013563006765612173,70659400.0,-1.0
560,ACGL,2022-05-19,42.9996337890625,43.655752485712576,42.429092480010596,43.05668538079461,1797500.0,-0.5705375671386719,0.5705375671386719,0.0,39.14208524486355,42.429092480010596,45.1866987774054,20.689730422755165,-79.31026957724482,-0.41863991993140104,-0.37406862076223446,-0.028362655895306843,68861900.0,-1.0
561,ACGL,2022-05-20,43.1898078918457,43.60820555107926,42.32449040668979,43.3419551333051,2001500.0,0.19017410278320312,0.0,0.19017410278320312,41.88232415669966,42.32449040668979,45.1866987774054,30.23251186074783,-69.76748813925218,-0.43636512347146805,-0.3865279213040812,0.004422691219095443,70863400.0,1.0
562,ACGL,2022-05-23,44.03611373901367,44.17874634696682,43.32293981707748,43.59869764340963,1264400.0,0.8463058471679688,0.0,0.8463058471679688,52.79606092938828,42.32449040668979,45.1866987774054,59.80079402450854,-40.19920597549146,-0.3777679917305221,-0.38477593538936944,0.011356224331820153,72127800.0,1.0
563,ACGL,2022-05-24,43.86494827270508,44.15972448249317,43.170792811663304,43.93151087668238,1452300.0,-0.17116546630859375,0.17116546630859375,0.0,50.57951560985443,42.32449040668979,44.69223252915903,65.06020446216485,-34.93979553783515,-0.34120773492414,-0.3760622952963236,0.00874699891852293,70675500.0,-1.0
564,ACGL,2022-05-25,44.13119888305664,44.30236090186381,43.532131817231566,43.532131817231566,1276400.0,0.2662506103515625,0.0,0.2662506103515625,54.042524670612536,42.32449040668979,44.60665092282815,79.1665819994107,-20.833418000589305,-0.28743588691474997,-0.3583370136200089,0.025862011632265425,71951900.0,1.0
565,ACGL,2022-05-26,44.758792877197266,44.91093649472717,44.38794303618001,44.45450564213747,1461800.0,0.627593994140625,0.0,0.627593994140625,61.39916328310675,42.32449040668979,44.91093649472717,94.11765749792413,-5.882342502075881,-0.19196684535869224,-0.3250629799677456,0.02281617080501941,73413700.0,1.0
566,ACGL,2022-05-27,45.129642486572266,45.167679297606995,44.67321163632534,44.82535525307432,1284900.0,0.370849609375,0.0,0.370849609375,65.19755672612675,42.32449040668979,45.167679297606995,98.66217783995145,-1.3378221600485554,-0.08539806224800373,-0.2771299964237972,0.029277755563188457,74698600.0,1.0
567,ACGL,2022-05-31,45.129642486572266,45.576565947755476,44.273836002630524,44.92044728066114,2508300.0,0.0,0.0,0.0,65.19755672612675,42.32449040668979,45.576565947755476,86.25728536930737,-13.742714630692635,-0.0009308041157112257,-0.22189015796218,0.012371930999167446,74698600.0,1.0
568,ACGL,2022-06-01,44.47352600097656,45.31031774783688,43.87445889365917,45.12964470025458,1864700.0,-0.6561164855957031,0.6561164855957031,0.0,52.92940408182651,42.32449040668979,45.576565947755476,66.08197033401463,-33.91802966598538,0.012918077953123941,-0.17492851077911922,0.020733327794149714,72833900.0,-1.0
569,ACGL,2022-06-02,45.13915252685547,45.15817093196155,44.0361104224321,44.46401184145428,1215700.0,0.6656265258789062,0.0,0.6656265258789062,61.42592206816989,42.32449040668979,45.576565947755476,86.54971523949688,-13.450284760503125,0.07671953943952303,-0.12459890073539077,0.04975667347048862,74049600.0,1.0
570,ACGL,2022-06-03,44.42597961425781,44.929954664545065,44.302361792104165,44.929954664545065,814700.0,-0.7131729125976562,0.7131729125976562,0.0,50.21931394345413,42.32449040668979,45.576565947755476,64.61993828345625,-35.38006171654375,0.0689408562436995,-0.08589094933957271,0.02862183887244152,73234900.0,-1.0
571,ACGL,2022-06-06,44.78731918334961,45.08209903266298,44.24530731299826,44.50205035064732,767200.0,0.3613395690917969,0.0,0.3613395690917969,55.017076673143606,42.32449040668979,45.576565947755476,75.73098304637674,-24.269016953623268,0.09088560447944616,-0.05053563857576893,0.01705884967025173,74002100.0,1.0
572,ACGL,2022-06-07,45.09160614013672,45.158172373828336,44.46401326115709,44.66370470745196,839800.0,0.3042869567871094,0.0,0.3042869567871094,58.868880337556035,42.32449040668979,45.576565947755476,85.0876831889385,-14.912316811061501,0.13131665330266884,-0.014165180200081373,0.027964420698859627,74841900.0,1.0
573,ACGL,2022-06-08,44.51156234741211,44.872901184009756,44.2072751021772,44.682724376280504,966600.0,-0.5800437927246094,0.5800437927246094,0.0,49.5387653109729,42.32449040668979,45.576565947755476,67.2515725143835,-32.74842748561651,0.11522561517413266,0.011712978874761441,0.008618924343374301,73875300.0,-1.0
574,ACGL,2022-06-09,43.56066131591797,44.51155980991617,43.56066131591797,44.51155980991617,1175100.0,-0.9509010314941406,0.9509010314941406,0.0,38.11276723928184,42.32449040668979,45.576565947755476,38.01175260594016,-61.98824739405984,0.025450211106097242,0.014460425321028602,-0.02676862989952744,72700200.0,-1.0
575,ACGL,2022-06-10,43.00914001464844,43.446552467244636,42.62878277963044,42.82847060006914,1277200.0,-0.5515213012695312,0.5515213012695312,0.0,33.01647268981898,42.62878277963044,45.576565947755476,12.903161912683217,-87.09683808731678,-0.08917267606961587,-0.0062661949571003,-0.04698691048914816,71423000.0,-1.0
576,ACGL,2022-06-13,41.83002853393555,42.6287834557491,41.554267085685495,42.15333418389318,2014100.0,-1.1791114807128906,1.1791114807128906,0.0,24.827101701893184,41.554267085685495,45.576565947755476,6.855816976964693,-93.14418302303531,-0.2720208946707743,-0.05941713489983512,-0.07311411681620295,69408900.0,-1.0
577,ACGL,2022-06-14,42.36252975463867,42.71436120311407,41.82051787033681,41.82051787033681,1706000.0,0.532501220703125,0.0,0.532501220703125,33.43118040807066,41.554267085685495,45.576565947755476,20.09454535004948,-79.90545464995053,-0.3696993629241945,-0.12147358050470702,-0.04746635664308552,71114900.0,1.0
578,ACGL,2022-06-15,41.83002853393555,42.66681664068111,41.26899824804996,42.54320244171943,2186000.0,-0.532501220703125,0.532501220703125,0.0,29.53112340405592,41.26899824804996,45.576565947755476,13.024294102770353,-86.97570589722964,-0.48449370907142253,-0.19407760621805015,-0.0733093956726627,68928900.0,-1.0
579,ACGL,2022-06-16,40.15644454956055,41.278505106910636,40.02331933553427,41.154887282147655,2030000.0,-1.673583984375,1.673583984375,0.0,20.75195938970468,40.02331933553427,45.576565947755476,2.397250173138469,-97.60274982686154,-0.7024162786346793,-0.29574534070137604,-0.09610446639036019,66898900.0,-1.0
580,ACGL,2022-06-17,41.26899719238281,41.48770341655519,40.0708630266159,40.0708630266159,4490600.0,1.1125526428222656,0.0,1.1125526428222656,35.46740144398615,40.02331933553427,45.576565947755476,22.431524184557937,-77.56847581544206,-0.776397952470397,-0.3918758630551803,-0.07855620865726631,71389500.0,1.0
581,ACGL,2022-06-21,41.58279037475586,41.97265860908212,41.34506575315717,41.80149659133987,1389700.0,0.3137931823730469,0.0,0.3137931823730469,39.144900718245964,40.02331933553427,45.31031774783688,29.49634022194465,-70.50365977805535,-0.8004810276512799,-0.4735968959744003,-0.07781527574059088,72779200.0,1.0
582,ACGL,2022-06-22,41.373592376708984,41.56377280327987,41.0217609453563,41.17390456113502,1593200.0,-0.209197998046875,0.209197998046875,0.0,37.50099045145642,40.02331933553427,45.158172373828336,26.296235376257478,-73.70376462374252,-0.8269154023220864,-0.5442605972439376,-0.07049786179625228,71186000.0,-1.0
583,ACGL,2022-06-23,41.44015884399414,41.91560809941919,41.04077958319433,41.801497666396415,1442000.0,0.06656646728515625,0.0,0.06656646728515625,38.450013512306604,40.02331933553427,45.158172373828336,27.59260095456566,-72.40739904543435,-0.8328924118411791,-0.6019869601633859,-0.0486792993463796,72628000.0,1.0
584,ACGL,2022-06-24,42.65730667114258,42.80945028383837,41.77297078878895,41.82051498762079,3394700.0,1.2171478271484375,0.0,1.2171478271484375,53.38396373091911,40.02331933553427,45.158172373828336,51.29625552990294,-48.70374447009706,-0.7309891890783007,-0.627787405946369,-0.008180431959021517,76022700.0,1.0
585,ACGL,2022-06-27,42.76190948486328,42.98061571879022,42.372041219621316,42.628784266593854,1025200.0,0.10460281372070312,0.0,0.10460281372070312,54.47919200038059,40.02331933553427,45.158172373828336,53.3333695999768,-46.6666304000232,-0.6344757366558298,-0.6291250720882612,0.022277798595612408,77047900.0,1.0
586,ACGL,2022-06-28,42.53369140625,43.43704574785723,42.53369140625,42.999633288515646,1055600.0,-0.22821807861328125,0.22821807861328125,0.0,51.436914697087005,40.02331933553427,44.872901184009756,51.76471186902209,-48.2352881309779,-0.569834721950329,-0.6172670020606748,0.004040402039318325,75992300.0,-1.0
587,ACGL,2022-06-29,42.438602447509766,42.7904338882551,42.37203984054146,42.7904338882551,1036600.0,-0.09508895874023438,0.09508895874023438,0.0,50.092091298162956,40.02331933553427,44.51155980991617,53.81358520697618,-46.186414793023815,-0.5202816533261441,-0.5978699323137686,0.014548732929514863,74955700.0,-1.0
588,ACGL,2022-06-30,43.25637435913086,43.55115057258823,41.92511500823401,42.16283963322345,2488800.0,0.8177719116210938,0.0,0.8177719116210938,60.37300081144781,40.02331933553427,43.55115057258823,91.64426545234825,-8.355734547651753,-0.4102935222425472,-0.5603546502995244,0.0771963216450704,77444500.0,1.0
589,ACGL,2022-07-01,43.69378662109375,43.92200022881847,42.76190653020636,43.00913854313979,962800.0,0.4374122619628906,0.0,0.4374122619628906,64.84275528172817,40.02331933553427,43.92200022881847,94.14638915131948,-5.853610848680525,-0.2845514895590071,-0.505194018151421,0.058755714790144964,78407300.0,1.0
590,ACGL,2022-07-05,42.257930755615234,43.17079613122149,41.820518288018775,43.17079613122149,1668700.0,-1.4358558654785156,1.4358558654785156,0.0,45.432635613771275,40.02331933553427,43.92200022881847,57.317115230699414,-42.682884769300586,-0.2973341086108263,-0.463622036243302,0.016236052818361157,76738600.0,-1.0
591,ACGL,2022-07-06,42.5432014465332,42.866507088927946,41.7064097319721,42.276947393896954,1493800.0,0.28527069091796875,0.0,0.28527069091796875,48.936683139224854,40.02331933553427,43.92200022881847,64.63422321482221,-35.365776785177786,-0.2812039218846323,-0.4271384133715681,0.028269458914151224,78232400.0,1.0
592,ACGL,2022-07-07,42.60025405883789,43.40851999792079,42.58123565266523,43.10423275393831,2038100.0,0.0570526123046875,0.0,0.0570526123046875,49.68231414109535,40.02331933553427,43.92200022881847,66.09760567330876,-33.90239432669124,-0.2608105025633378,-0.39387283120992206,0.027994468341954182,80270500.0,1.0
593,ACGL,2022-07-08,42.28645706176758,42.75239529108792,42.23890923529867,42.590744288741234,1030500.0,-0.3137969970703125,0.3137969970703125,0.0,45.46875447018912,40.0708630266159,43.92200022881847,57.53090369993878,-42.46909630006122,-0.2668927920059545,-0.36847682336912857,-0.008693694898132875,79240000.0,-1.0
594,ACGL,2022-07-11,42.40056610107422,42.56221711194575,41.90609842431827,41.90609842431827,1828300.0,0.11410903930664062,0.0,0.11410903930664062,47.3425672075166,41.0217609453563,43.92200022881847,47.5410826817009,-52.45891731829909,-0.25951388980683987,-0.34668423665667086,-0.008450122741056942,81068300.0,1.0
595,ACGL,2022-07-12,42.01069641113281,42.72387029276944,41.84904177838574,42.07725901656104,2270300.0,-0.38986968994140625,0.38986968994140625,0.0,41.69441966267473,41.0217609453563,43.92200022881847,34.09840944558095,-65.90159055441906,-0.28187599138625075,-0.3337225876025869,-0.012296017059086894,78798000.0,-1.0
596,ACGL,2022-07-13,42.039222717285156,42.29596575308591,41.392611433206966,41.801498087179645,2228600.0,0.02852630615234375,0.0,0.02852630615234375,42.2758341744697,41.04077958319433,43.92200022881847,34.653477011808,-65.346522988192,-0.29390829166126764,-0.32575972841432305,-0.009410765369066598,81026600.0,1.0
597,ACGL,2022-07-14,40.38466262817383,41.354579585635285,40.04233856937683,41.32605016247547,2275800.0,-1.6545600891113281,1.6545600891113281,0.0,25.35494152335015,40.04233856937683,43.92200022881847,8.823554444854981,-91.17644555514502,-0.4319736247213797,-0.34700250767573443,-0.06638817454082002,78750800.0,-1.0
598,ACGL,2022-07-15,41.01225280761719,41.33555843866832,40.31809734658767,40.82207238451831,10441200.0,0.6275901794433594,0.0,0.6275901794433594,36.481760852325976,40.04233856937683,43.92200022881847,24.999969672096274,-75.00003032790372,-0.48515751950266406,-0.3746335100411204,-0.061371055723104084,89192000.0,1.0
599,ACGL,2022-07-18,40.97421646118164,41.6493535248021,40.91716124538938,41.2689963016901,1745000.0,-0.038036346435546875,0.038036346435546875,0.0,36.10539292164585,40.04233856937683,43.92200022881847,24.019565972640144,-75.98043402735985,-0.5243311909757153,-0.4045730462280394,-0.03037806800947096,87447000.0,-1.0
600,ACGL,2022-07-19,41.72542953491211,41.839536345640084,41.36408706898508,41.440160694397136,1487200.0,0.7512130737304688,0.0,0.7512130737304688,48.267584184279755,40.04233856937683,43.92200022881847,43.38241613000628,-56.617583869993716,-0.4891217004535804,-0.42148277707314763,-0.019222152631104605,88934200.0,1.0
601,ACGL,2022-07-20,41.6113166809082,41.81100812232603,41.26899626859887,41.63984610247641,1456600.0,-0.11411285400390625,0.11411285400390625,0.0,46.70921785281131,40.04233856937683,43.92200022881847,40.44110670612396,-59.55889329387605,-0.46506490050119,-0.43019920175875614,-0.02321435399337768,87477600.0,-1.0
602,ACGL,2022-07-21,41.6968994140625,41.73493622613214,40.98372551101201,41.42114159503275,1278500.0,0.08558273315429688,0.0,0.08558273315429688,48.157650031965666,40.04233856937683,43.92200022881847,42.64703961127873,-57.352960388721264,-0.43408998278827227,-0.43097735796465936,-0.013941996768466858,88756100.0,1.0
603,ACGL,2022-07-22,41.52573776245117,41.9346244274202,41.18341733290067,41.83953602377674,960900.0,-0.17116165161132812,0.17116165161132812,0.0,45.315413353883955,40.04233856937683,43.40851999792079,44.06771365606352,-55.932286343936475,-0.41852891140054993,-0.4284876686518375,-0.020632468362276946,87795200.0,-1.0
604,ACGL,2022-07-25,41.91560745239258,42.29596467442729,41.56377239708835,41.84904122046186,1665200.0,0.38986968994140625,0.0,0.38986968994140625,52.65878142305327,40.04233856937683,43.40851999792079,55.649670785155166,-44.350329214844834,-0.3704669125527289,-0.41688351743201574,-0.002263446380646905,89460400.0,1.0
605,ACGL,2022-07-26,42.067752838134766,42.32449225080916,41.73493617402603,41.88707979472458,1066000.0,0.1521453857421875,0.0,0.1521453857421875,55.358135808123656,40.04233856937683,43.40851999792079,60.16949210114401,-39.830507898856,-0.3164527013443461,-0.3967973542144818,0.0006786548134221082,90526400.0,1.0
606,ACGL,2022-07-27,42.10578536987305,42.32449159452407,41.59230292509629,41.99167856296599,1314000.0,0.03803253173828125,0.0,0.03803253173828125,56.08044437676132,40.04233856937683,42.75239529108792,76.14035470052396,-23.859645299476043,-0.2674936421524521,-0.37093661180207593,0.042618227556975974,91840400.0,1.0
607,ACGL,2022-07-28,41.164398193359375,43.22784626026126,40.9551993562025,42.761908012362774,1960100.0,-0.9413871765136719,0.9413871765136719,0.0,38.355942122074225,40.04233856937683,43.22784626026126,35.22388682951238,-64.77611317048762,-0.3011834572407821,-0.3569859808898172,0.003709754410611943,89880300.0,-1.0
608,ACGL,2022-07-29,42.21989440917969,42.45761903169221,41.21194070386625,41.259484902890776,2173800.0,1.0554962158203125,0.0,1.0554962158203125,56.246144083556466,40.04233856937683,43.22784626026126,68.35820381266376,-31.64179618733624,-0.2399471930736965,-0.3335782233265931,0.030401507474296263,92054100.0,1.0
609,ACGL,2022-08-01,41.35457992553711,42.01069862536406,40.94569325498998,41.734937172689925,1611600.0,-0.8653144836425781,0.8653144836425781,0.0,44.130903519463864,40.04233856937683,43.22784626026126,41.19410415851001,-58.80589584149,-0.25826355809863344,-0.3185152902810012,-0.008887856003128913,90442500.0,-1.0
610,ACGL,2022-08-02,41.297523498535156,41.83002798184601,41.18341669046499,41.35457871626526,2092800.0,-0.057056427001953125,0.057056427001953125,0.0,43.41936041497845,40.04233856937683,43.22784626026126,39.40297908399757,-60.59702091600243,-0.27422232193200813,-0.3096566966112026,-0.007541053910390172,88349700.0,-1.0
611,ACGL,2022-08-03,41.36408615112305,41.49721136525,40.86961847908719,41.288012527399054,1659300.0,0.06656265258789062,0.0,0.06656265258789062,44.621279600115365,40.31809734658767,43.22784626026126,35.947734171152405,-64.0522658288476,-0.27829074499181417,-0.3033835062873249,-0.007981726881764462,90009000.0,1.0
612,ACGL,2022-08-04,41.41162872314453,41.70640856239348,41.15488569426123,41.27850351425465,1053400.0,0.047542572021484375,0.0,0.047542572021484375,45.57410419761612,40.86961847908719,43.22784626026126,22.98379522047264,-77.01620477952737,-0.27451428158691726,-0.2976096613472434,-0.0027479111860553296,91062400.0,1.0
613,ACGL,2022-08-05,41.65886688232422,41.896591520400364,41.31654282311215,41.40212383791517,1236600.0,0.2472381591796875,0.0,0.2472381591796875,50.66724994686961,40.86961847908719,43.22784626026126,33.46786131253594,-66.53213868746407,-0.24870444392388436,-0.28782861786257163,-0.0061251783207475485,92299000.0,1.0
614,ACGL,2022-08-08,41.98217010498047,42.229402118216484,41.83953387943552,41.83953387943552,1173600.0,0.32330322265625,0.0,0.32330322265625,56.771017313052646,40.86961847908719,43.22784626026126,47.17744548575306,-52.822554514246946,-0.1998582519939518,-0.27023454468884767,-0.0020344023005839373,93472600.0,1.0
615,ACGL,2022-08-09,42.45762252807617,42.647799339835345,42.14382425937123,42.29596788521267,779400.0,0.4754524230957031,0.0,0.4754524230957031,64.271973276403,40.86961847908719,43.22784626026126,67.33887462721594,-32.66112537278405,-0.12138302796150668,-0.24046424134337946,0.008356028871387977,94252000.0,1.0
616,ACGL,2022-08-10,43.00914001464844,43.12324682241483,42.704852775678035,42.80945219420974,704800.0,0.5515174865722656,0.0,0.5515174865722656,71.00568577951069,40.86961847908719,43.22784626026126,90.72582184983267,-9.274178150167332,-0.014520611024771313,-0.19527551527965784,0.04481401167639709,94956800.0,1.0
617,ACGL,2022-08-11,43.722312927246094,43.74133133267753,43.26588207906147,43.26588207906147,867100.0,0.7131729125976562,0.0,0.7131729125976562,77.36956468581133,40.86961847908719,43.74133133267753,99.33773303944157,-0.6622669605584329,0.12626026833258663,-0.13096835855720895,0.03558555839826405,95823900.0,1.0
618,ACGL,2022-08-12,44.73026657104492,44.76830338183999,43.931511681298055,44.064636891690874,1265700.0,1.0079536437988281,0.0,1.0079536437988281,83.33465477249989,40.86961847908719,44.76830338183999,99.02436817173368,-0.975631828266319,0.3155263731083977,-0.04166941222408759,0.08162787898187007,97089600.0,1.0
619,ACGL,2022-08-15,44.68272399902344,44.7968308081756,43.83642125125722,44.14070849392303,1076400.0,-0.047542572021484375,0.047542572021484375,0.0,82.15608886113368,40.86961847908719,44.7968308081756,97.09445785991795,-2.9055421400820545,0.4564234708414858,0.05794916438902713,0.08197102910077292,96013200.0,-1.0
620,ACGL,2022-08-16,45.177188873291016,45.23424409260464,44.50205176800202,44.5971438001914,1185200.0,0.4944648742675781,0.0,0.4944648742675781,84.74512222244945,40.86961847908719,45.23424409260464,98.69278090801367,-1.3072190919863178,0.6010560191968324,0.16657053535058822,0.09218389856932552,97198400.0,1.0
621,ACGL,2022-08-17,45.18669891357422,45.348349923717166,44.94897427932397,44.9679926853508,904200.0,0.009510040283203125,0.0,0.009510040283203125,84.79408375536157,40.86961847908719,45.348349923717166,96.39069651437201,-3.609303485627996,0.7082811127833253,0.27491265083713573,0.09115966473252568,98102600.0,1.0
622,ACGL,2022-08-18,45.48147964477539,45.5670570324647,45.18669978674843,45.18669978674843,669500.0,0.2947807312011719,0.0,0.2947807312011719,86.35986014250122,40.86961847908719,45.5670570324647,98.17821166329507,-1.8217883367049315,0.8077330693610705,0.3814767345419227,0.09175988327404805,98772100.0,1.0
623,ACGL,2022-08-19,44.95848083496094,45.50049270080958,44.9204476510026,45.50049270080958,990900.0,-0.5229988098144531,0.5229988098144531,0.0,71.32474128015924,40.86961847908719,45.5670570324647,87.04450967078236,-12.95549032921765,0.8347256309184203,0.47212651381722226,0.07089463747438307,97781200.0,-1.0
624,ACGL,2022-08-22,44.15021896362305,44.72075662970471,44.05513056173944,44.72075662970471,887900.0,-0.8082618713378906,0.8082618713378906,0.0,54.42759457211556,40.86961847908719,45.5670570324647,69.83807126496775,-30.161928735032244,0.7818843759529912,0.5340780862443761,0.03986554909963691,96893300.0,-1.0
625,ACGL,2022-08-23,44.207275390625,44.35941901423517,43.93151393927214,44.045620750132244,1090800.0,0.057056427001953125,0.0,0.057056427001953125,55.29032490962305,41.15488569426123,45.5670570324647,69.18112336060427,-30.81887663939572,0.7361256789067028,0.5744876047768415,0.027857692006129087,97984100.0,1.0
626,ACGL,2022-08-24,44.387943267822266,44.51156109126978,43.88396821226006,44.04561921974606,1095500.0,0.18066787719726562,0.0,0.18066787719726562,58.182692340141244,41.31654282311215,45.5670570324647,72.2595030491136,-27.74049695088639,0.7062982035738443,0.6008497245362421,0.015224042279825767,99079600.0,1.0
627,ACGL,2022-08-25,44.96799087524414,45.0725902904862,44.33088699485614,44.464012204295145,1017200.0,0.580047607421875,0.0,0.580047607421875,66.26692021869175,41.83953387943552,45.5670570324647,83.92857314021698,-16.07142685978301,0.7211517206022791,0.6249101237494495,0.0053146185440600124,100096800.0,1.0
628,ACGL,2022-08-26,44.21678161621094,45.1486617397174,44.21678161621094,45.053573337735315,610000.0,-0.7512092590332031,0.7512092590332031,0.0,51.414073685974024,42.14382425937123,45.5670570324647,60.55554775979894,-39.44445224020106,0.6646453133301478,0.6328571616655893,-0.010427797168827135,99486800.0,-1.0
629,ACGL,2022-08-29,43.96955108642578,44.29285674248002,43.313428757362395,43.89347746034707,685600.0,-0.24723052978515625,0.24723052978515625,0.0,47.38125633657905,42.704852775678035,45.5670570324647,44.1861655313026,-55.8138344686974,0.5930775125120746,0.6249012318348863,-0.0267311405818611,98801200.0,-1.0
630,ACGL,2022-08-30,43.49409866333008,44.102673118432136,43.38949924872381,44.102673118432136,753400.0,-0.4754524230957031,0.4754524230957031,0.0,40.35702848395653,43.26588207906147,45.5670570324647,9.917393891807153,-90.08260610819285,0.4923193269801729,0.5983848508639437,-0.03745793100490635,98047800.0,-1.0
631,ACGL,2022-08-31,43.47508239746094,43.77936963998502,43.0757031245293,43.532133988315415,1969000.0,-0.019016265869140625,0.019016265869140625,0.0,40.08279774846075,43.0757031245293,45.5670570324647,16.030611775370236,-83.96938822462975,0.40625028489034065,0.5599579376692231,-0.044114599238746055,96078800.0,-1.0
632,ACGL,2022-09-01,43.47508239746094,43.51311558223391,42.99012211085752,43.4180271792164,1106500.0,0.0,0.0,0.0,40.08279774846074,42.99012211085752,45.5670570324647,18.819267903783825,-81.18073209621618,0.33418764182976446,0.5148038785013314,-0.03299485236045763,96078800.0,1.0
633,ACGL,2022-09-02,43.26588439941406,44.416470784297374,43.09472236874165,43.741333678528505,945400.0,-0.209197998046875,0.209197998046875,0.0,36.454703089627046,42.99012211085752,45.5670570324647,10.701173950662094,-89.2988260493379,0.25723174053548803,0.4632894509081627,-0.020030128614710097,95133400.0,-1.0
634,ACGL,2022-09-06,42.82847213745117,44.150220559310306,42.56221807325203,43.29441040186691,1153100.0,-0.4374122619628906,0.4374122619628906,0.0,29.920769986047134,42.56221807325203,45.5670570324647,8.860843053928672,-91.13915694607132,0.15911395377472104,0.4024543514814744,-0.03118950989379976,93980300.0,-1.0
635,ACGL,2022-09-07,43.87445831298828,43.941020920988144,42.81896034700462,42.81896034700462,914100.0,1.0459861755371094,0.0,1.0459861755371094,53.10992571134583,42.56221807325203,45.5670570324647,43.670900755363014,-56.32909924463699,0.16386827212437538,0.35473713561005465,-0.011568117759720997,94894400.0,1.0
636,ACGL,2022-09-08,44.188255310058594,44.27383632180873,43.5606624330209,43.74133184565343,885100.0,0.3137969970703125,0.0,0.3137969970703125,57.92885638533014,42.56221807325203,45.50049270080958,55.339865836782266,-44.660134163217734,0.19075795980423038,0.3219413004488898,-0.01733979103822514,95779500.0,1.0
637,ACGL,2022-09-09,44.235801696777344,44.559107354102245,44.04562125822326,44.235801696777344,855800.0,0.04754638671875,0.0,0.04754638671875,58.671425405373476,42.56221807325203,45.1486617397174,64.70597621066425,-35.29402378933576,0.2134443731970066,0.30024191499851316,0.0004301552458407798,96635300.0,1.0
638,ACGL,2022-09-12,44.77781295776367,45.07259281473745,44.43548889866899,44.492544117648144,1187100.0,0.5420112609863281,0.0,0.5420112609863281,66.45849058077252,42.56221807325203,45.1486617397174,85.66182643906072,-14.338173560939282,0.27202357974357483,0.2945982479475255,0.018382308924400625,97822400.0,1.0
639,ACGL,2022-09-13,44.739776611328125,45.177189079222735,43.87445906510612,44.40696356562356,1636500.0,-0.038036346435546875,0.038036346435546875,0.0,65.4597875551037,42.56221807325203,45.177189079222735,83.27276031375199,-16.72723968624802,0.311784747211199,0.2980355478002602,0.028640160074136167,96185900.0,-1.0
640,ACGL,2022-09-14,44.71125030517578,45.053574363932505,44.29285624857873,44.78732030301611,1194800.0,-0.02852630615234375,0.02852630615234375,0.0,64.61946904719538,42.56221807325203,45.177189079222735,82.18187609028601,-17.81812390971399,0.33710795374250324,0.30585002898870883,0.028433940536638058,94991100.0,-1.0
641,ACGL,2022-09-15,44.95848083496094,45.357860099338346,44.473524186134775,44.63517519328017,911900.0,0.24723052978515625,0.0,0.24723052978515625,68.64465040056126,42.56221807325203,45.357860099338346,85.7142201808824,-14.28577981911759,0.37282848028131355,0.3192457192472298,0.034120658448404395,95903000.0,1.0
642,ACGL,2022-09-16,44.235801696777344,44.79683199544731,44.00758444503441,44.67321416627863,2268000.0,-0.7226791381835938,0.7226791381835938,0.0,49.60883579016155,42.56221807325203,45.357860099338346,59.8640172063875,-40.1359827936125,0.33891627232662813,0.32317982986310945,0.02241760016759109,93635000.0,-1.0
643,ACGL,2022-09-19,45.14866256713867,45.15817358394519,43.826914167458504,43.8554399630979,1132000.0,0.9128608703613281,0.0,0.9128608703613281,64.11338521347652,42.56221807325203,45.357860099338346,92.51701289908941,-7.482987100910588,0.38130539509948136,0.3348049429103839,0.054174018214827147,94767000.0,1.0
644,ACGL,2022-09-20,44.15021896362305,45.00602909013556,43.72231390036679,44.85388184329776,1180200.0,-0.998443603515625,0.998443603515625,0.0,47.02948784971774,42.56221807325203,45.357860099338346,56.80272637030337,-43.197273629696625,0.3305229628593125,0.3339485469001696,0.006285220632641586,93586800.0,-1.0
645,ACGL,2022-09-21,42.60025405883789,44.43548853951413,42.590746669446595,44.25481912195894,1304300.0,-1.5499649047851562,1.5499649047851562,0.0,31.83492265961958,42.56221807325203,45.357860099338346,1.3605456360628794,-98.63945436393712,0.16332558949331144,0.299823955418798,-0.03593717923638473,92282500.0,-1.0
646,ACGL,2022-09-22,41.772972106933594,42.609763816860315,41.54475486699359,42.4861459940849,1311600.0,-0.8272819519042969,0.8272819519042969,0.0,26.551790935016754,41.54475486699359,45.357860099338346,5.985075838037279,-94.01492416196272,-0.03552476574015628,0.23275421118700715,-0.05567503007463681,90970900.0,-1.0
647,ACGL,2022-09-23,40.983726501464844,41.658867236151856,40.51778823821663,41.48770520509206,1301700.0,-0.78924560546875,0.78924560546875,0.0,22.450503122468746,40.51778823821663,45.357860099338346,9.626680690237277,-90.37331930976272,-0.2538741263651261,0.1354285436765805,-0.08473139275197672,89669200.0,-1.0
648,ACGL,2022-09-26,39.623939514160156,40.8220736784884,39.034383448516884,40.68894846631637,2021900.0,-1.3597869873046875,1.3597869873046875,0.0,17.176246035081775,39.034383448516884,45.357860099338346,9.323289990589036,-90.67671000941097,-0.5305254463393112,0.0022377456734021146,-0.11434650516052502,87647300.0,-1.0
649,ACGL,2022-09-27,40.983726501464844,41.14538114297248,39.500327068800175,39.76657750494201,2626500.0,1.3597869873046875,0.0,1.3597869873046875,34.839398203035216,39.034383448516884,45.357860099338346,30.82707758072811,-69.17292241927188,-0.6327561459490383,-0.124761032651086,-0.08336881161382859,90273800.0,1.0
650,ACGL,2022-09-28,42.28645706176758,42.63828848782027,41.021760327404024,41.021760327404024,3209500.0,1.3027305603027344,0.0,1.3027305603027344,47.27024421408054,39.034383448516884,45.357860099338346,51.42856995966337,-48.57143004033663,-0.6017190009929081,-0.22015262631945046,-0.05943314194717009,93483300.0,1.0
651,ACGL,2022-09-29,43.579681396484375,43.73182501627758,42.02971577601046,42.0392231652644,2830400.0,1.2932243347167969,0.0,1.2932243347167969,56.7262424264368,39.034383448516884,45.357860099338346,71.87973007502173,-28.120269924978274,-0.4673817581468285,-0.2695984526849261,-0.014832336594473139,96313700.0,1.0
652,ACGL,2022-09-30,43.30392074584961,44.19776407509588,43.246865527110025,43.484590164106486,2344300.0,-0.2757606506347656,0.2757606506347656,0.0,54.32911782870705,39.034383448516884,45.357860099338346,67.51882758637345,-32.481172413626545,-0.3788034943363243,-0.29143946101520574,-0.04085927946472001,93969400.0,-1.0
653,ACGL,2022-10-03,44.05513000488281,44.29285463397701,42.7143596144972,43.541643935465764,2149100.0,0.7512092590332031,0.0,0.7512092590332031,59.68411595294751,39.034383448516884,45.357860099338346,79.39851498801217,-20.60148501198783,-0.24516219582304188,-0.28218400797677295,-0.0021537596182383822,96118500.0,1.0
654,ACGL,2022-10-04,46.29924774169922,46.32777716399142,44.140707660941885,44.17874447240483,2469300.0,2.2441177368164062,0.0,2.2441177368164062,71.28823976799211,39.034383448516884,46.32777716399142,99.60883200050382,-0.3911679994961806,0.04135433553110346,-0.21747633927519766,0.08683031978523914,98587800.0,1.0
655,ACGL,2022-10-05,45.6050910949707,46.13759555972817,45.348348065215674,45.88085252997313,2197500.0,-0.6941566467285156,0.6941566467285156,0.0,64.64706742839762,39.034383448516884,46.32777716399142,90.09122368524572,-9.908776314754272,0.20998750553641798,-0.1319835703128745,0.09173680479874324,96390300.0,-1.0
656,ACGL,2022-10-06,45.64312744140625,45.74772685550852,45.319821810267364,45.386384414261556,2502600.0,0.038036346435546875,0.0,0.038036346435546875,64.85407728442348,39.034383448516884,46.32777716399142,90.6127414850437,-9.387258514956294,0.3427487289823219,-0.03703711045383519,0.11368905020813247,98892900.0,1.0
657,ACGL,2022-10-07,43.42753219604492,45.39589540296086,43.31342539317975,45.35785859287585,2712200.0,-2.215595245361328,2.215595245361328,0.0,46.53859427058901,39.034383448516884,46.32777716399142,60.23463039170651,-39.76536960829349,0.26611532345975064,0.023593376328881997,0.09599228972488971,96180700.0,-1.0
658,ACGL,2022-10-10,44.34990692138672,44.54959474239483,43.42753418522062,43.49410041961335,1485900.0,0.9223747253417969,0.0,0.9223747253417969,52.924738322375184,39.034383448516884,46.32777716399142,72.88134550575248,-27.118654494247522,0.27662200293844563,0.07419910165079474,0.08213456186814927,97666600.0,1.0
659,ACGL,2022-10-11,44.302364349365234,45.02504566370732,43.92200347188614,44.321382755978206,1479700.0,-0.047542572021484375,0.047542572021484375,0.0,52.5513972333813,39.034383448516884,46.32777716399142,72.22948748360001,-27.770512516399986,0.27790877452900986,0.11494103622643778,0.04767264575164187,96186900.0,-1.0
660,ACGL,2022-10-12,43.32293701171875,44.49254173267001,43.31342599537033,44.159725080883774,1750300.0,-0.9794273376464844,0.9794273376464844,0.0,45.004916221778586,39.034383448516884,46.32777716399142,58.80052182158708,-41.19947817841292,0.1976189216378117,0.13147661330871258,-0.005891378195948427,94436600.0,-1.0
661,ACGL,2022-10-13,45.196205139160156,45.47196657836363,42.42909061283178,42.83797726340521,3025800.0,1.8732681274414062,0.0,1.8732681274414062,58.239297461776246,39.034383448516884,46.32777716399142,84.48497271674246,-15.51502728325753,0.28189619325241466,0.16156052929745301,0.043697761327810225,97462400.0,1.0
662,ACGL,2022-10-14,44.692230224609375,45.7096913459146,44.44499820665248,45.62411033443146,1909400.0,-0.5039749145507812,0.5039749145507812,0.0,54.19107454984396,39.500327068800175,46.32777716399142,76.04454200940985,-23.955457990590144,0.304509775342396,0.19015037850644162,0.0144614309311073,95553000.0,-1.0
663,ACGL,2022-10-17,45.71920394897461,45.842818148547785,44.768305400558894,45.03455583335047,1736000.0,1.0269737243652344,0.0,1.0269737243652344,60.626160815241484,41.021760327404024,46.32777716399142,88.53050727580766,-11.469492724192326,0.400680602281426,0.23225642326143853,-0.012528147238171972,97289000.0,1.0
664,ACGL,2022-10-18,46.251705169677734,46.765191260338376,45.83331111102283,46.251705169677734,1556700.0,0.532501220703125,0.0,0.532501220703125,63.67878810091832,42.02971577601046,46.765191260338376,89.15660967182646,-10.843390328173538,0.5139406854119031,0.2885932756915315,0.01417855022722092,98845700.0,1.0
665,ACGL,2022-10-19,46.32777786254883,46.80322713083479,45.79527337620814,45.79527337620814,1543500.0,0.07607269287109375,0.0,0.07607269287109375,64.13710664790602,42.42909061283178,46.80322713083479,89.13044285817062,-10.869557141829379,0.6028888207954495,0.3514523847123151,0.015000076890469227,100389200.0,1.0
666,ACGL,2022-10-20,45.18669891357422,46.18514165194726,44.987011091377624,45.633622386729506,1970100.0,-1.1410789489746094,1.1410789489746094,0.0,52.64066848812927,42.42909061283178,46.80322713083479,63.04348959829471,-36.95651040170528,0.5746807620376302,0.3960980601773782,0.04050809771063868,98419100.0,-1.0
667,ACGL,2022-10-21,45.86183547973633,46.11857851707696,45.053573183485824,45.59558505318605,1935500.0,0.6751365661621094,0.0,0.6751365661621094,57.80420191377807,42.42909061283178,46.80322713083479,78.47822885216553,-21.52177114783446,0.5998884106017073,0.436856130262244,0.03409090713605356,100354600.0,1.0
668,ACGL,2022-10-24,46.91733169555664,47.050456903927085,46.05201421375885,46.05201421375885,1063300.0,1.0554962158203125,0.0,1.0554962158203125,64.73920269299788,42.42909061283178,47.050456903927085,97.11935388833045,-2.8806461116695483,0.6970007859740122,0.48888506140459764,0.05902545799971226,101417900.0,1.0
669,ACGL,2022-10-25,46.803226470947266,46.850770671627515,45.548040710560635,46.375321410045004,1851200.0,-0.114105224609375,0.114105224609375,0.0,63.438649868539876,42.42909061283178,47.050456903927085,94.65027402272362,-5.349725977276371,0.7560405403740802,0.5423161571984941,0.08033364539174959,99566700.0,-1.0
670,ACGL,2022-10-26,46.39434051513672,47.221621227091404,46.213667471482324,46.88880818992286,2069300.0,-0.4088859558105469,0.4088859558105469,0.0,58.57339477473521,42.42909061283178,47.221621227091404,82.73812358144971,-17.261876418550283,0.7610632285103378,0.5860655714608629,0.026509645495401024,97497400.0,-1.0
671,ACGL,2022-10-27,49.15194320678711,49.31359784147544,46.9838957413411,47.316708772478876,4057900.0,2.7576026916503906,0.0,2.7576026916503906,74.05649089166985,42.42909061283178,49.31359784147544,97.6519069656031,-2.348093034396894,0.9763049997059028,0.6641134571098709,0.09978721043377314,101555300.0,1.0
672,ACGL,2022-10-28,53.89693069458008,54.19171055416954,52.40402024491789,52.489601260450954,13153300.0,4.744987487792969,0.0,4.744987487792969,85.10743310077017,42.42909061283178,54.19171055416954,97.49392685422482,-2.5060731457751735,1.5123332525211808,0.8337574161921331,0.17886852874193315,114708600.0,1.0
673,ACGL,2022-10-31,54.676666259765625,55.15211553158967,53.411969455566414,53.554605688069664,93699400.0,0.7797355651855469,0.0,0.7797355651855469,86.22036474364913,42.42909061283178,55.15211553158967,96.26307992902632,-3.7369200709736843,1.9772649685875834,1.0624589266712232,0.18215460509359183,208408000.0,1.0
674,ACGL,2022-11-01,52.717811584472656,55.104568853089795,52.61321579638032,54.69568220750821,9579300.0,-1.9588546752929688,1.9588546752929688,0.0,70.86867965970016,42.42909061283178,55.15211553158967,80.86694034900414,-19.133059650995865,2.1627328635611107,1.282513714049201,0.1379309351051241,198828700.0,-1.0
675,ACGL,2022-11-02,53.45951461791992,54.99996916611755,52.12825527226426,52.461068294983235,6385800.0,0.7417030334472656,0.0,0.7417030334472656,72.97123818269915,44.44499820665248,55.15211553158967,84.19181501142579,-15.808184988574212,2.34256313307678,1.494523597854717,0.18308077162637182,205214500.0,1.0
676,ACGL,2022-11-03,53.75429153442383,54.400902810511504,53.02209924746013,53.12669866379637,3742700.0,0.29477691650390625,0.0,0.29477691650390625,73.83717051914735,44.768305400558894,55.15211553158967,86.5384287701042,-13.461571229895794,2.480274885916124,1.6916738554669986,0.1720920231850449,208957200.0,1.0
677,ACGL,2022-11-04,54.068092346191406,54.38188698268363,52.86995813713716,54.03005553346807,3714100.0,0.3138008117675781,0.0,0.3138008117675781,74.82774783420889,44.987011091377624,55.15211553158967,89.33583819257194,-10.664161807428048,2.584936011889475,1.870326286751494,0.15241192097273482,212671300.0,1.0
678,ACGL,2022-11-07,55.16162109375,55.342294132588,53.86840216423403,54.22974098713013,2725700.0,1.0935287475585938,0.0,1.0935287475585938,78.15363094726835,44.987011091377624,55.342294132588,98.25525735878983,-1.7447426412101608,2.724710571794759,2.041203143760147,0.17858586369021245,215397000.0,1.0
679,ACGL,2022-11-08,54.8858642578125,55.2757325096294,54.61010281381298,55.066533672472524,3021100.0,-0.2757568359375,0.2757568359375,0.0,75.26032097458896,44.987011091377624,55.342294132588,95.59229938033494,-4.4077006196650705,2.781172025585434,2.189196920125205,0.1830293015999509,212375900.0,-1.0
680,ACGL,2022-11-09,54.73371887207031,55.72265055355938,54.36286541069828,54.70518945049406,1982900.0,-0.1521453857421875,0.1521453857421875,0.0,73.52741301958618,45.053573183485824,55.72265055355938,90.73086034352892,-9.269139656471085,2.781576985384042,2.3076729331769723,0.11356164784371026,210393000.0,-1.0
681,ACGL,2022-11-10,55.532474517822266,56.09350478465504,54.534028178920416,55.8938133404407,2463300.0,0.7987556457519531,0.0,0.7987556457519531,76.76783896302919,45.548040710560635,56.09350478465504,94.67989020785743,-5.3201097921425715,2.8139137776465404,2.4089211020708863,0.030345769270431866,212856300.0,1.0
682,ACGL,2022-11-11,53.98250961303711,56.23613809800677,53.6496929533864,55.95086926644188,3240200.0,-1.5499649047851562,1.5499649047851562,0.0,60.25401834944863,45.548040710560635,56.23613809800677,78.914596272142,-21.085403727857994,2.6835375537935917,2.4638443924154276,-0.01269566515688092,209616100.0,-1.0
683,ACGL,2022-11-14,53.5926399230957,54.41992060061604,53.57362151785053,54.11563337147316,2036600.0,-0.38986968994140625,0.38986968994140625,0.0,56.71324399002147,46.213667471482324,56.23613809800677,73.62428613245267,-26.375713867547333,2.5197085991124126,2.4750172337548246,0.01659454959015627,207579500.0,-1.0
684,ACGL,2022-11-15,53.45000457763672,54.08710846797665,52.8889743095302,53.96349064554234,2373600.0,-0.14263534545898438,0.14263534545898438,0.0,55.340434128142626,46.9838957413411,56.23613809800677,69.88693753398263,-30.11306246601737,2.3512596344211687,2.4502657138880934,-0.00017789237989107587,205205900.0,-1.0
685,ACGL,2022-11-16,53.74478530883789,54.05857993724957,53.402461257923314,53.5260790823958,1392000.0,0.2947807312011719,0.0,0.2947807312011719,57.77761893453055,52.12825527226426,56.23613809800677,39.35190230946857,-60.64809769053142,2.2160042402498163,2.4034134191604384,-0.0001768458910829107,206597900.0,1.0
686,ACGL,2022-11-17,53.773311614990234,53.982510454179504,53.2503181444071,53.42148017149105,2027600.0,0.02852630615234375,0.0,0.02852630615234375,58.03334364026851,52.12825527226426,56.23613809800677,40.046330737990935,-59.95366926200907,2.0870569075265877,2.3401421168336682,-0.0054520275898347625,208625500.0,1.0
687,ACGL,2022-11-18,54.83831787109375,54.952428309301006,53.992018738368934,54.04907395747256,2015200.0,1.0650062561035156,0.0,1.0650062561035156,66.71706865767769,52.12825527226426,56.23613809800677,65.97224686757318,-34.02775313242682,2.0472034347114985,2.281554380409234,-0.005861017429251714,210640700.0,1.0
688,ACGL,2022-11-21,54.35335922241211,55.1711325294575,54.28679661624702,54.87635268259068,1448400.0,-0.4849586486816406,0.4849586486816406,0.0,60.174957178857994,52.12825527226426,56.23613809800677,54.16668499412847,-45.833315005871526,1.953963090192751,2.2160361223659377,-0.009702043369474556,209192300.0,-1.0
689,ACGL,2022-11-22,54.94291687011719,55.095060492500664,54.52452281541015,54.695684844015325,1685700.0,0.5895576477050781,0.0,0.5895576477050781,64.99041342661886,52.86995813713716,56.23613809800677,61.581934331416576,-38.41806566858342,1.90567439227911,2.153963776348572,0.00382210458850496,210878000.0,1.0
690,ACGL,2022-11-23,55.19965744018555,55.54198148206042,54.86684441469048,54.94291440877939,1046200.0,0.2567405700683594,0.0,0.2567405700683594,66.99566256796913,52.86995813713716,56.23613809800677,69.20899447237333,-30.79100552762667,1.8666050089929271,2.096492022877443,-0.005993197323305055,211924200.0,1.0
691,ACGL,2022-11-25,55.84627151489258,56.00792615495001,55.29475224106214,55.351803832643505,614800.0,0.6466140747070312,0.0,0.6466140747070312,71.70527708311329,52.8889743095302,56.23613809800677,88.35233027865556,-11.647669721344444,1.866304990907814,2.0504546164835173,0.03452529189945919,212539000.0,1.0
692,ACGL,2022-11-28,55.1711311340332,55.893812394428515,55.14260533993822,55.703635597275465,1608000.0,-0.675140380859375,0.675140380859375,0.0,61.18646817138741,52.8889743095302,56.23613809800677,68.18180909938998,-31.818190900610027,1.7909441487394417,1.9985525229347023,0.029453507295080117,210931000.0,-1.0
693,ACGL,2022-11-29,56.0839958190918,56.12203263151308,54.88586524694206,55.351803503237484,2059100.0,0.9128646850585938,0.0,0.9128646850585938,68.41508749270994,52.8889743095302,56.23613809800677,95.45459115449447,-4.545408845505541,1.7843122484271277,1.9557044680331876,0.049279532570089435,212990100.0,1.0
694,ACGL,2022-11-30,56.96833038330078,57.12047400192649,55.513456803480594,55.798725634980045,4182400.0,0.8843345642089844,0.0,0.8843345642089844,73.85735429137483,52.8889743095302,57.12047400192649,96.40449888489655,-3.59550111510345,1.8293274798181756,1.9304290703901856,0.05997875060695068,217172500.0,1.0
695,ACGL,2022-12-01,56.8256950378418,57.491324739955104,56.30270156739207,57.491324739955104,1685500.0,-0.14263534545898438,0.14263534545898438,0.0,71.5625562984581,52.8889743095302,57.491324739955104,85.53717905283771,-14.462820947162289,1.8323704685372988,1.9108173500196084,0.05676391003600867,215487000.0,-1.0
696,ACGL,2022-12-02,57.62445068359375,57.76708691706105,56.255158077346074,56.47386430857653,2161700.0,0.7987556457519531,0.0,0.7987556457519531,76.31720432096441,52.8889743095302,57.76708691706105,97.07599547318571,-2.924004526814278,1.8775912608582814,1.904172132187343,0.050806314282820564,217648700.0,1.0
697,ACGL,2022-12-05,56.26466369628906,57.46279786301987,55.82725124759241,57.40574264595032,1492400.0,-1.3597869873046875,1.3597869873046875,0.0,57.44950469337725,52.8889743095302,57.76708691706105,69.200726968612,-30.799273031387997,1.7831505691212683,1.8799678195741283,0.0351644222403249,216156300.0,-1.0
698,ACGL,2022-12-06,57.56739807128906,57.719541691507544,56.19810186193271,56.321719686919614,1809700.0,1.302734375,0.0,1.302734375,66.5823368596889,53.2503181444071,57.76708691706105,95.57894468760563,-4.421055312394377,1.7927596004484272,1.862526175748988,0.0477674166330857,217966000.0,1.0
699,ACGL,2022-12-07,57.19654846191406,57.700523525850954,56.88275020349973,57.386725267436624,1853200.0,-0.370849609375,0.370849609375,0.0,62.19740374513057,53.2503181444071,57.76708691706105,87.36843783987302,-12.631562160126977,1.7502742903363924,1.8400757986664689,0.036175786487304684,216112800.0,-1.0
700,ACGL,2022-12-08,57.5864143371582,58.19498879541569,57.45328550044822,57.46279651676531,2142900.0,0.3898658752441406,0.0,0.3898658752441406,64.99389243184413,53.992018738368934,58.19498879541569,85.52037130892374,-14.479628691076257,1.7281423446517152,1.8176891078635182,0.03115951656327809,218255700.0,1.0
701,ACGL,2022-12-09,57.091949462890625,57.976285399165356,57.044405261159845,57.47230670412691,1561000.0,-0.4944648742675781,0.4944648742675781,0.0,58.64509774836978,54.28679661624702,58.19498879541569,71.7762258876508,-28.223774112349208,1.651664079918433,1.7844841022745015,0.034815641611388504,216694700.0,-1.0
702,ACGL,2022-12-12,57.05391311645508,57.3486929734172,56.635519059461515,57.13949413122537,2142200.0,-0.038036346435546875,0.038036346435546875,0.0,58.14100261205862,54.52452281541015,58.19498879541569,68.91196689530713,-31.088033104692865,1.5698885903984277,1.7415649998992868,0.01729401201176728,214552500.0,-1.0
703,ACGL,2022-12-13,56.958824157714844,57.89070429425815,56.435827057326705,57.6910128434781,1540700.0,-0.09508895874023438,0.09508895874023438,0.0,56.73428924147713,54.86684441469048,58.19498879541569,62.85724126453059,-37.1427587354694,1.4803435624089047,1.6893207124012106,-0.00016686860088710453,213011800.0,-1.0
704,ACGL,2022-12-14,57.35820007324219,57.89070456550054,56.920787612131804,57.16801963833634,2016600.0,0.39937591552734375,0.0,0.39937591552734375,61.27490990875245,54.88586524694206,58.19498879541569,74.71267814828249,-25.287321851717508,1.4251762367337264,1.6364918172677139,0.009370849490635935,215028400.0,1.0
705,ACGL,2022-12-15,57.767086029052734,57.957266461622275,57.072930533455455,57.13949314074628,2115800.0,0.4088859558105469,0.0,0.4088859558105469,65.54635460767363,54.88586524694206,58.19498879541569,87.0689999906371,-12.9310000093629,1.3983303314775597,1.5888595201096833,0.0024752573563289193,217144200.0,1.0
706,ACGL,2022-12-16,58.0333366394043,58.432715911786254,57.01587549347915,57.4913247626924,6451200.0,0.2662506103515625,0.0,0.2662506103515625,68.18314677898496,54.88586524694206,58.432715911786254,88.73989039514578,-11.260109604854218,1.3826011913592922,1.5476078543596052,0.03143487985038629,223595400.0,1.0
707,ACGL,2022-12-19,57.56739807128906,58.66092920805,57.43427285702165,57.89070371767709,1738100.0,-0.4659385681152344,0.4659385681152344,0.0,59.05680690566663,55.513456803480594,58.66092920805,65.25684752077949,-34.74315247922052,1.3173527634242888,1.5015568361725422,0.0,221857300.0,-1.0
708,ACGL,2022-12-20,59.18392562866211,59.288521419115746,57.99530247569355,58.69896535091254,2582400.0,1.6165275573730469,0.0,1.6165275573730469,73.34121626314051,55.82725124759241,59.288521419115746,96.97810961669013,-3.0218903833098625,1.3801733983833202,1.477280148614698,0.03474645271770904,224439700.0,1.0
709,ACGL,2022-12-21,60.248931884765625,60.41058289490857,59.17441552228529,59.383614361190325,1831600.0,1.0650062561035156,0.0,1.0650062561035156,78.9294382054735,55.82725124759241,60.41058289490857,96.4730675721971,-3.5269324278029055,1.4986211368195015,1.481548346255659,0.04623516810786055,226271300.0,1.0
710,ACGL,2022-12-22,59.76396942138672,60.24892968892069,59.30753857554822,59.992186658000925,1396400.0,-0.48496246337890625,0.48496246337890625,0.0,71.09876265346362,55.82725124759241,60.41058289490857,85.89206447889306,-14.107935521106944,1.535657303623097,1.4923701377291467,0.04680204448497394,224874900.0,-1.0
711,ACGL,2022-12-23,60.267948150634766,60.32499973929925,59.5737926785608,59.821024693350054,890300.0,0.5039787292480469,0.0,0.5039787292480469,74.17141118563654,56.19810186193271,60.41058289490857,96.61399675969476,-3.3860032403052416,1.5873773066870385,1.5113715715207252,0.05633329702766199,225765200.0,1.0
712,ACGL,2022-12-27,60.49616241455078,60.743398059404676,60.02071315779017,60.267948802644064,666700.0,0.22821426391601562,0.0,0.22821426391601562,75.53065474265563,56.435827057326705,60.743398059404676,94.26043947425062,-5.739560525749389,1.628014033198383,1.534700063856257,0.06210342838260319,226431900.0,1.0
713,ACGL,2022-12-28,59.5262451171875,60.66732405163948,59.51673772816429,60.54370622999812,1107900.0,-0.9699172973632812,0.9699172973632812,0.0,60.03695634864044,56.435827057326705,60.743398059404676,71.74386814216128,-28.256131857838714,1.5639267378469697,1.5405453986543995,0.03779834515687175,225324000.0,-1.0
714,ACGL,2022-12-29,60.011207580566406,60.239421199363356,59.52624729269028,59.659376135610245,1063400.0,0.48496246337890625,0.0,0.48496246337890625,64.26593592025415,56.435827057326705,60.743398059404676,83.002242366172,-16.997757633828,1.5345798312987782,1.5393522851832755,0.03884775407201668,226387400.0,1.0
715,ACGL,2022-12-30,59.69740676879883,59.84955038395698,59.33606794991692,59.640355180233215,1116100.0,-0.3138008117675781,0.3138008117675781,0.0,59.5602053199053,56.435827057326705,60.743398059404676,75.71737552088493,-24.28262447911507,1.4690666080639048,1.5252951497594016,0.028674383134893455,225271300.0,-1.0
716,ACGL,2023-01-03,59.39311981201172,59.65937386030712,58.813071142990566,59.535756038862466,1492900.0,-0.3042869567871094,0.3042869567871094,0.0,55.05014959290627,56.435827057326705,60.743398059404676,68.65337224292801,-31.34662775707199,1.3767234809645217,1.4955808160004258,0.03171450859150804,223778400.0,-1.0
717,ACGL,2023-01-04,59.68790054321289,60.03022459083845,59.30753968420893,59.78298894426889,1870700.0,0.2947807312011719,0.0,0.2947807312011719,58.557918276215474,56.920787612131804,60.743398059404676,72.3880439623452,-27.611956037654807,1.3122009926381466,1.45890485132797,0.008515401930464517,225649100.0,1.0
718,ACGL,2023-01-05,59.849552154541016,60.0302251967169,59.3455770945557,59.450176513207,1548000.0,0.161651611328125,0.0,0.161651611328125,60.50794807536072,57.01587549347915,60.743398059404676,76.0203757574913,-23.979624242508716,1.25959061331303,1.4190420037249822,-0.006628826731542414,227197100.0,1.0
719,ACGL,2023-01-06,60.76241683959961,60.91455683021549,59.89709933205569,60.106294539695,1557900.0,0.9128646850585938,0.0,0.9128646850585938,69.7749783357357,57.01587549347915,60.91455683021549,96.09765514348915,-3.9023448565108545,1.276838460646303,1.3906012951092466,0.01670651109488719,228755000.0,1.0
720,ACGL,2023-01-09,59.59280776977539,60.84799713784086,59.383612564589434,60.58174308891064,1934500.0,-1.1696090698242188,1.1696090698242188,0.0,51.803856107781684,57.43427285702165,60.91455683021549,62.021804237223364,-37.97819576277663,1.1824987176804669,1.3489807796234907,-0.011202312366299871,226820500.0,-1.0
721,ACGL,2023-01-10,59.97317123413086,59.98268225096548,59.1458905116336,59.84004601756694,1867100.0,0.38036346435546875,0.0,0.38036346435546875,56.05129860763677,57.99530247569355,60.91455683021549,67.75253260729343,-32.247467392706575,1.1254524294058896,1.3042751095799705,-0.008645030685353494,228687600.0,1.0
722,ACGL,2023-01-11,59.76396942138672,60.229911283587015,59.53575581216243,59.73544362708116,1189100.0,-0.20920181274414062,0.20920181274414062,0.0,53.08249739384462,58.813071142990566,60.91455683021549,45.248858185270045,-54.751141814729955,1.0512439115997125,1.253668869983919,0.0039936049003463925,227498500.0,-1.0
723,ACGL,2023-01-12,59.97317123413086,60.39156529010175,59.37410413220314,59.60232138016278,1359500.0,0.20920181274414062,0.0,0.20920181274414062,55.78468835659933,58.813071142990566,60.91455683021549,55.20380644001634,-44.796193559983664,0.9978118110690559,1.2024974582009464,-0.0006338207139805485,228858000.0,1.0
724,ACGL,2023-01-13,60.62928771972656,60.67683554738805,59.43115718689044,59.73544442149612,1045900.0,0.6561164855957031,0.0,0.6561164855957031,63.41071744696995,58.813071142990566,60.91455683021549,86.42536029519037,-13.574639704809638,0.9969177561017375,1.1613815177811047,0.015610074228798565,229903900.0,1.0
725,ACGL,2023-01-17,60.857505798339844,61.00014202851071,60.23942030411945,61.00014202851071,1905000.0,0.22821807861328125,0.0,0.22821807861328125,65.77952001612542,58.813071142990566,61.00014202851071,93.478207262727,-6.521792737273002,1.0030618303488978,1.1297175802946633,0.024655818568937393,231808900.0,1.0
726,ACGL,2023-01-18,60.40107345581055,61.209339361266,60.14433042424634,60.857504302794716,1422600.0,-0.4564323425292969,0.4564323425292969,0.0,57.22946463961968,58.813071142990566,61.209339361266,66.2698065562481,-33.7301934437519,0.9600341024450572,1.095780884724742,0.011948366521642662,230386300.0,-1.0
727,ACGL,2023-01-19,60.27745819091797,60.439112829820864,59.963663557291284,60.19187717676704,1287100.0,-0.12361526489257812,0.12361526489257812,0.0,54.99563500432462,58.813071142990566,61.209339361266,61.111149276156866,-38.888850723843134,0.9055213132703273,1.057728970433859,0.0071496948761125,229099200.0,-1.0
728,ACGL,2023-01-20,59.39311981201172,60.35352933437491,58.813071142990566,60.27745571275053,1927100.0,-0.88433837890625,0.88433837890625,0.0,41.594057347181554,58.813071142990566,61.209339361266,24.206333189137226,-75.79366681086277,0.7819470201492322,1.0025725803769336,-0.022535262729962757,227172100.0,-1.0
729,ACGL,2023-01-23,60.03022384643555,60.125312246312404,59.231468954344166,59.47870097045796,1159000.0,0.6371040344238281,0.0,0.6371040344238281,51.432252953850714,58.813071142990566,61.209339361266,50.79367552272396,-49.20632447727604,0.7270415907331866,0.9474663824481843,0.007340081681501243,228331100.0,1.0
730,ACGL,2023-01-24,60.89554214477539,61.028667357309736,59.849551595424124,60.267949266120624,1248500.0,0.8653182983398438,0.0,0.8653182983398438,61.57555684303029,58.813071142990566,61.209339361266,86.90475406311391,-13.095245936886087,0.7447673824744143,0.9069265824534304,0.015379725494982788,229579600.0,1.0
731,ACGL,2023-01-25,61.618228912353516,61.77036890779483,60.429602098033605,60.46763891058898,1428200.0,0.722686767578125,0.0,0.722686767578125,68.01316910330488,58.813071142990566,61.77036890779483,94.8554387301819,-5.14456126981811,0.8078179599420139,0.8871048579511471,0.031026377747647382,231007800.0,1.0
732,ACGL,2023-01-26,61.5706787109375,62.112690573105134,61.542152916314976,61.932017534122615,1220700.0,-0.047550201416015625,0.047550201416015625,0.0,67.1589460850065,58.813071142990566,62.112690573105134,83.57350374346612,-16.42649625653387,0.8442174793841062,0.8785273822377391,0.026637035259817976,229787100.0,-1.0
733,ACGL,2023-01-27,60.91455841064453,61.67528014780073,60.82898102397404,61.30443029600162,1039700.0,-0.6561203002929688,0.6561203002929688,0.0,55.96735009372133,58.813071142990566,62.112690573105134,63.68877721092212,-36.311222789077874,0.8107748284463128,0.8649768714794539,0.00470516315871472,228747400.0,-1.0
734,ACGL,2023-01-30,60.847999572753906,61.5136292806306,60.63880073180663,60.914558553412476,909600.0,-0.066558837890625,0.066558837890625,0.0,54.89656217541426,58.813071142990566,62.112690573105134,61.67161010118929,-38.32838989881071,0.7700241851909979,0.8459863342217626,-0.00015620465316867893,227837800.0,-1.0
735,ACGL,2023-01-31,61.1903190612793,61.475591522688916,60.46763777327032,60.74339921802494,1402600.0,0.3423194885253906,0.0,0.3423194885253906,59.49538831667172,58.813071142990566,62.112690573105134,72.04612436793019,-27.953875632069806,0.7566293761959457,0.8281149426165991,0.013066747994903816,229240400.0,1.0
736,ACGL,2023-02-01,61.02866744995117,61.31393990854637,60.486655582444286,60.80045020855301,2019200.0,-0.161651611328125,0.161651611328125,0.0,56.3640099359239,58.813071142990566,62.112690573105134,67.14702570664876,-32.852974293351245,0.724617025496201,0.8074153591925195,0.012462523828624006,227221200.0,-1.0
737,ACGL,2023-02-02,58.337623596191406,60.82898036640492,57.786104332844246,60.57223732699864,2226300.0,-2.6910438537597656,2.6910438537597656,0.0,28.02818486888151,57.786104332844246,62.112690573105134,12.747215303719544,-87.25278469628044,0.47660821509822426,0.7412539303736605,-0.017771354984569276,224994900.0,-1.0
738,ACGL,2023-02-03,58.25204086303711,58.565839111064776,57.71954002137552,58.35664027904633,2014000.0,-0.08558273315429688,0.08558273315429688,0.0,27.520489252200022,57.71954002137552,62.112690573105134,12.121160779521619,-87.87883922047838,0.270040772795781,0.6470112988580846,-0.02962146181475589,222980900.0,-1.0
739,ACGL,2023-02-06,59.107852935791016,59.17441554321342,58.04284758964245,58.33762381468738,1407500.0,0.8558120727539062,0.0,0.8558120727539062,40.050087778253825,57.71954002137552,62.112690573105134,31.6017604693494,-68.3982395306506,0.17339270531075357,0.5522875801486185,-0.02935665150552813,224388400.0,1.0
740,ACGL,2023-02-07,60.25843811035156,60.35353013864924,58.81307192673666,58.98423395028251,1293100.0,1.1505851745605469,0.0,1.1505851745605469,52.72722683955549,57.71954002137552,62.112690573105134,57.79219398653343,-42.20780601346658,0.18747987200040228,0.4793260385189752,-0.022067995559173492,225681500.0,1.0
741,ACGL,2023-02-08,61.01915740966797,61.34246668490066,59.640357432217655,60.00169626474351,1721100.0,0.7607192993164062,0.0,0.7607192993164062,59.29390474407787,57.71954002137552,62.112690573105134,75.10822471115554,-24.891775288844446,0.25706446383092185,0.43487372358136456,-0.008957531617587278,227402600.0,1.0
742,ACGL,2023-02-09,60.95259475708008,62.4455051696442,60.91455794503499,61.33295562275083,2407000.0,-0.06656265258789062,0.06656265258789062,0.0,58.47383590047711,57.71954002137552,62.4455051696442,68.41046504308144,-31.589534956918552,0.3033429556417815,0.408567569993448,0.0006244212783934611,224995600.0,-1.0
743,ACGL,2023-02-10,61.06670379638672,61.52313102092731,60.7814313399639,61.114244369270565,2002700.0,0.11410903930664062,0.0,0.11410903930664062,59.579638953103505,57.71954002137552,62.4455051696442,70.82497796746142,-29.17502203253858,0.3452468488782614,0.39590342577041077,0.003594271383914771,226998300.0,1.0
744,ACGL,2023-02-13,62.04612731933594,62.15072673504594,60.990629400647606,61.142776643418465,2510300.0,0.9794235229492188,0.0,0.9794235229492188,68.01495444334229,57.71954002137552,62.4455051696442,91.54928490205707,-8.450715097942934,0.45227374884149896,0.4071774903846284,0.013986007446694204,229508600.0,1.0
745,ACGL,2023-02-14,63.02555465698242,63.5960923353361,62.03661929560528,62.75930422406938,4909300.0,0.9794273376464844,0.0,0.9794273376464844,74.22217308830183,57.71954002137552,63.5960923353361,90.2912856404207,-9.708714359579302,0.6091035720569593,0.4475627067190947,0.032720478595880786,234417900.0,1.0
746,ACGL,2023-02-15,64.64208221435547,64.87980683564943,62.97800986529778,62.997024642898225,2980900.0,1.6165275573730469,0.0,1.6165275573730469,81.17830254000101,57.71954002137552,64.87980683564943,96.67994744525355,-3.3200525547464594,0.8539883546850717,0.5288478363122902,0.10806848530209323,237398800.0,1.0
747,ACGL,2023-02-16,63.80529022216797,64.65158933759898,63.719712836346446,64.58502673036665,2189900.0,-0.8367919921875,0.8367919921875,0.0,69.91034711167309,57.71954002137552,64.87980683564943,84.99334394439845,-15.006656055601548,0.9693649530404613,0.6169512596579244,0.0953314128888243,235208900.0,-1.0
748,ACGL,2023-02-17,64.48043060302734,64.92735409788072,63.32984418796888,63.60560564766097,3198100.0,0.675140380859375,0.0,0.675140380859375,73.35359475315579,57.71954002137552,64.92735409788072,93.79945861380936,-6.200541386190638,1.1025701820992353,0.7140750441461866,0.09089448187320515,238407000.0,1.0
749,ACGL,2023-02-21,64.23320007324219,64.82275253227353,63.98596441844636,64.82275253227353,2137600.0,-0.24723052978515625,0.24723052978515625,0.0,69.97044190346809,57.71954002137552,64.92735409788072,90.36942383265378,-9.630576167346218,1.1746462573949117,0.8061892867959318,0.06596191483774638,236269400.0,-1.0
750,ACGL,2023-02-22,64.60404968261719,64.8132485239743,64.18565199990297,64.18565199990297,1498000.0,0.370849609375,0.0,0.370849609375,72.19037072821436,57.71954002137552,64.92735409788072,95.5145289288553,-4.485471071144693,1.2473132794440147,0.8944140853255487,0.05875027491581242,237767400.0,1.0
751,ACGL,2023-02-23,65.0224380493164,65.52642035787309,64.42337459469537,64.64208444593922,2478500.0,0.41838836669921875,0.0,0.41838836669921875,74.63162204113262,57.71954002137552,65.52642035787309,93.54438281575108,-6.455617184248913,1.3234074452938813,0.9802127573192152,0.06677063229967883,240245900.0,1.0
752,ACGL,2023-02-24,65.77365112304688,65.79267315677026,64.91784097499998,65.03195141299963,1181700.0,0.7512130737304688,0.0,0.7512130737304688,78.53529676609685,58.04284758964245,65.79267315677026,99.75454887908609,-0.24545112091391222,1.4278696444163614,1.0697441347386445,0.0770787849030532,241427600.0,1.0
753,ACGL,2023-02-27,65.81168365478516,66.03039349969612,65.5454332382186,65.95431987931146,1469200.0,0.03803253173828125,0.0,0.03803253173828125,78.72652820837455,58.81307192673666,66.03039349969612,96.96965359378771,-3.0303464062122907,1.4964751631334323,1.155090340417602,0.060689627187670236,242896800.0,1.0
754,ACGL,2023-02-28,66.56289672851562,66.88619874461686,65.97333703148512,65.97333703148512,2151700.0,0.7512130737304688,0.0,0.7512130737304688,82.3169632206376,59.640357432217655,66.88619874461686,95.53810244853143,-4.46189755146856,1.593097906891579,1.2426918537123974,0.056125520684193075,245048500.0,1.0
755,ACGL,2023-03-01,67.48526763916016,67.49477865548913,66.19204510005412,66.2681187211262,2655900.0,0.9223709106445312,0.0,0.9223709106445312,85.7292521572306,60.7814313399639,67.49477865548913,99.85832676484685,-0.1416732351531506,1.7242239707205727,1.3389982771140325,0.04398350621467584,247704400.0,1.0
756,ACGL,2023-03-02,67.41870880126953,67.64692242245681,66.48682502801945,67.30459836328578,1766600.0,-0.066558837890625,0.066558837890625,0.0,84.37361444660667,60.7814313399639,67.64692242245681,96.67593157655936,-3.3240684234406377,1.8019992533677112,1.4315984723647683,0.05663195898834972,245937800.0,-1.0
757,ACGL,2023-03-03,67.79906463623047,68.22696605101486,67.09539453644415,67.40919277650185,3066300.0,0.3803558349609375,0.0,0.3803558349609375,85.84908758773291,60.990629400647606,68.22696605101486,94.08676744243691,-5.913232557563092,1.872740475856041,1.519826873063023,0.05146730569518421,249004100.0,1.0
758,ACGL,2023-03-06,68.1794204711914,68.73094334980581,67.66594165844549,67.81808164801986,3749900.0,0.3803558349609375,0.0,0.3803558349609375,87.23934046013778,62.03661929560528,68.73094334980581,91.76133581002345,-8.238664189976557,1.9371645147727747,1.603294401404974,0.06143583681724607,252754000.0,1.0
759,ACGL,2023-03-07,67.50428771972656,68.26500948064493,66.90522422998009,68.12237324362519,3132000.0,-0.6751327514648438,0.6751327514648438,0.0,72.62602853798556,62.97800986529778,68.73094334980581,78.67773661241716,-21.322263387582836,1.9117064965448378,1.6649768204329467,0.044892511403812785,249622000.0,-1.0
760,ACGL,2023-03-08,66.83866119384766,68.08433599599826,66.20156089463936,67.71348613497968,2738200.0,-0.6656265258789062,0.6656265258789062,0.0,61.00170688232176,63.32984418796888,68.73094334980581,64.96486920053908,-35.035130799460916,1.8168765144266814,1.6953567592316938,0.027932252296564597,246883800.0,-1.0
761,ACGL,2023-03-09,65.0224380493164,66.98129392965271,64.72766183026509,66.98129392965271,3191700.0,-1.81622314453125,1.81622314453125,0.0,40.561796215996104,63.32984418796888,68.73094334980581,31.337951972943756,-68.66204802705624,1.576990476856679,1.6716835027566908,-0.011421185549288282,243692100.0,-1.0
762,ACGL,2023-03-10,63.339351654052734,65.0129350979367,62.99702760292238,64.75618843219891,3069600.0,-1.6830863952636719,1.6830863952636719,0.0,29.8626257258515,62.99702760292238,68.73094334980581,5.970161862186741,-94.02983813781326,1.2368108719946775,1.584708976604288,-0.037566764188879054,240622500.0,-1.0
763,ACGL,2023-03-13,61.97956466674805,62.76881216476146,61.057191958802235,62.16974146528582,3559100.0,-1.3597869873046875,1.3597869873046875,0.0,23.968861992133682,61.057191958802235,68.73094334980581,12.019840895903497,-87.9801591040965,0.8477206427366752,1.4373113098307657,-0.06885716047577106,237063400.0,-1.0
764,ACGL,2023-03-14,64.03350067138672,64.1000705301059,62.42648716062563,63.23474942411324,3347100.0,2.053936004638672,0.0,2.053936004638672,43.428220013794835,61.057191958802235,68.73094334980581,38.785576453177754,-61.214423546822246,0.697063983229512,1.289261844510515,-0.051148451929239336,240410500.0,1.0
765,ACGL,2023-03-15,59.65937423706055,62.217289928399936,59.31705019236889,61.351968800212724,2857200.0,-4.374126434326172,4.374126434326172,0.0,26.66088811832776,59.31705019236889,68.73094334980581,3.6363706169877643,-96.36362938301224,0.22215122693742728,1.0758397209958976,-0.11509171122041528,237553300.0,-1.0
766,ACGL,2023-03-16,62.82586669921875,63.42493017200414,59.05079830751768,59.05079830751768,3699600.0,3.166492462158203,0.0,3.166492462158203,44.54500922174439,59.05079830751768,68.73094334980581,38.9980560746716,-61.0019439253284,0.1001346344939904,0.8806987036955162,-0.07335201397976432,241252900.0,1.0
767,ACGL,2023-03-17,60.04924392700195,62.40746823076365,59.94464450778558,62.236306204298685,4795300.0,-2.776622772216797,2.776622772216797,0.0,35.729535499526506,59.05079830751768,68.73094334980581,10.314366314993414,-89.68563368500658,-0.2181005195857466,0.6609388590392636,-0.11924678279752743,236457600.0,-1.0
768,ACGL,2023-03-20,62.38845443725586,62.80685212072767,60.51518313325005,60.524694150087186,2419000.0,2.3392105102539062,0.0,2.3392105102539062,46.098748248494836,59.05079830751768,68.73094334980581,34.47940206636867,-65.52059793363134,-0.27834089282356445,0.473082908666698,-0.0757853086860395,238876600.0,1.0
769,ACGL,2023-03-21,63.909889221191406,64.20466544345658,63.46296575209258,63.67216458909884,1635700.0,1.5214347839355469,0.0,1.5214347839355469,51.92017175625197,59.05079830751768,68.73094334980581,50.19646805338739,-49.80353194661261,-0.2009977735042341,0.33826677223251156,-0.043818531376056846,240512300.0,1.0
770,ACGL,2023-03-22,62.63568878173828,64.26172439743658,62.60715573182354,63.748238320671845,2322200.0,-1.274200439453125,1.274200439453125,0.0,47.01351801641078,59.05079830751768,68.73094334980581,37.03343760408394,-62.96656239591606,-0.2397563586833087,0.2226621460493475,-0.03670654837285381,238190100.0,-1.0
771,ACGL,2023-03-23,62.37894058227539,63.501001110259466,61.73232930759338,62.55010260365533,2018300.0,-0.2567481994628906,0.2567481994628906,0.0,46.00275192091353,59.05079830751768,68.73094334980581,34.38111991316841,-65.61888008683158,-0.2878718432259646,0.12055534819428505,-0.015162944468123385,236171800.0,-1.0
772,ACGL,2023-03-24,62.80685043334961,62.81635419515122,60.56272570817838,61.713315679423836,1661800.0,0.42790985107421875,0.0,0.42790985107421875,48.14661863767562,59.05079830751768,68.26500948064493,40.763686171923766,-59.236313828076234,-0.2881533105941898,0.038813616436590065,0.013347718252777696,237833600.0,1.0
773,ACGL,2023-03-27,63.12063980102539,63.90037628062105,62.9304630029893,63.386897474967654,1861500.0,0.31378936767578125,0.0,0.31378936767578125,49.831957205202656,59.05079830751768,68.08433599599826,45.052576674335526,-54.94742332566448,-0.2600584045798371,-0.020960787766695386,-0.014255988830690902,239695100.0,1.0
774,ACGL,2023-03-28,63.5295295715332,63.577077400771316,62.55010522938148,63.0065397238148,1056100.0,0.4088897705078125,0.0,0.4088897705078125,52.16935301482421,59.05079830751768,66.98129392965271,56.47479649966404,-43.525203500335955,-0.20246511014541113,-0.05726165224243855,0.06487086705090683,240751200.0,1.0
775,ACGL,2023-03-29,64.4709243774414,64.62306437244959,63.88136466668178,64.16663713264487,1304300.0,0.9413948059082031,0.0,0.9413948059082031,57.43736839142682,59.05079830751768,65.0129350979367,90.90911967390124,-9.090880326098748,-0.07993784240900226,-0.061796890275751304,0.02618440086307805,242055500.0,1.0
776,ACGL,2023-03-30,64.5279769897461,64.89882684849795,63.59609320699767,64.51846597278879,1315200.0,0.0570526123046875,0.0,0.0570526123046875,57.76267198315042,59.05079830751768,64.89882684849795,93.65854909645003,-6.3414509035499735,0.021521482780961776,-0.045133215664408685,0.07458433728472347,243370700.0,1.0
777,ACGL,2023-03-31,64.53748321533203,65.49788546808993,63.71970993244331,64.56600900930587,2787600.0,0.0095062255859375,0.0,0.0095062255859375,57.82464457014382,59.05079830751768,65.49788546808993,85.1033152051778,-14.896684794822216,0.10152547939784284,-0.015801476651958375,0.034445937112249636,246158300.0,1.0
778,ACGL,2023-04-03,65.24114990234375,65.63101453420151,64.59453860007072,64.59453860007072,1773800.0,0.7036666870117188,0.0,0.7036666870117188,62.521355645670525,59.05079830751768,65.63101453420151,94.07520029088408,-5.9247997091159155,0.21918264289750056,0.031195347257933426,0.020830276775239964,247932100.0,1.0
779,ACGL,2023-04-04,64.55650329589844,65.4503502726602,63.88136618220106,65.27918823997774,2639700.0,-0.6846466064453125,0.6846466064453125,0.0,55.5735080807142,59.05079830751768,65.63101453420151,83.67057857543101,-16.329421424568984,0.25425068965062536,0.07580641573647183,0.03066645472445373,245292400.0,-1.0
780,ACGL,2023-04-05,65.22212982177734,65.33624026257671,63.966943992105975,64.32829009391375,1790200.0,0.6656265258789062,0.0,0.6656265258789062,60.49791549584314,59.94464450778558,65.63101453420151,92.80938963653963,-7.190610363460373,0.33192662361960146,0.12703045731309776,0.04557931271294824,247082600.0,1.0
781,ACGL,2023-04-06,65.55494689941406,66.03039616383155,65.06998661836981,65.39328863587929,1979200.0,0.33281707763671875,0.0,0.33281707763671875,62.872206691804124,60.51518313325005,66.03039616383155,91.37931278844252,-8.620687211557481,0.4155507077245062,0.18473450739537947,0.04375472495600974,249061800.0,1.0
782,ACGL,2023-04-10,65.27918243408203,65.51690705528787,64.95587317675663,65.51690705528787,1581200.0,-0.27576446533203125,0.27576446533203125,0.0,59.45565688150132,60.56272570817838,66.03039616383155,86.26080822093398,-13.73919177906602,0.45433422700843096,0.23865445131798982,0.03419709685866601,247480600.0,-1.0
783,ACGL,2023-04-11,65.62150573730469,65.77364572069459,65.088997658491,65.37427010266903,1292200.0,0.34232330322265625,0.0,0.34232330322265625,62.38353567415699,60.56272570817838,66.03039616383155,92.521670246163,-7.478329753837001,0.5068504189892735,0.29229364485224657,0.03292919339841727,248772800.0,1.0
784,ACGL,2023-04-12,66.78160858154297,67.32362046666118,65.54543756050413,65.58347437320474,1505800.0,1.1601028442382812,0.0,1.1601028442382812,70.66663167778965,60.56272570817838,67.32362046666118,91.98313382354964,-8.01686617645037,0.6347633271301589,0.36078758130782906,0.0358407177563298,250278600.0,1.0
785,ACGL,2023-04-13,67.03834533691406,67.19049258167519,65.95432160972082,66.36320826154143,2362900.0,0.25673675537109375,0.0,0.25673675537109375,72.22819055165172,60.56272570817838,67.32362046666118,95.78051219641914,-4.219487803580867,0.7482266478726416,0.4382753946207916,0.03890356500044745,252641500.0,1.0
786,ACGL,2023-04-14,66.80062103271484,67.51379492274383,66.32517177269553,67.32361812064809,1437700.0,-0.23772430419921875,0.23772430419921875,0.0,68.34120858813728,62.55010522938148,67.51379492274383,85.63218222559986,-14.367817774400141,0.8096318504228179,0.5125466857811969,0.03506702933908601,251203800.0,-1.0
787,ACGL,2023-04-17,67.46624755859375,67.49478060840622,66.22057281030993,66.80062149190316,1226400.0,0.6656265258789062,0.0,0.6656265258789062,73.03028297626037,62.55010522938148,67.51379492274383,99.04209636203369,-0.9579036379663157,0.9016131781271497,0.5903599842503875,0.03410573939270911,252430200.0,1.0
788,ACGL,2023-04-18,68.7024154663086,68.88308849979101,67.69446539483758,67.78955379227791,1343300.0,1.2361679077148438,0.0,1.2361679077148438,79.52785259701488,63.59609320699767,68.88308849979101,96.5826897230513,-3.4173102769487005,1.0620152118086281,0.6846910297620357,0.06422144878893343,253773500.0,1.0
789,ACGL,2023-04-19,68.58831024169922,68.96867111510595,68.25549719801091,68.39813343238598,2314200.0,-0.114105224609375,0.114105224609375,0.0,77.53824919578547,63.59609320699767,68.96867111510595,92.92032838029785,-7.07967161970216,1.1664811722818769,0.781049058266004,0.0516110165233814,251459300.0,-1.0
790,ACGL,2023-04-20,68.64537048339844,69.11130875403133,68.19844699217121,68.68340729699015,2177200.0,0.05706024169921875,0.0,0.05706024169921875,77.85787551274694,63.71970993244331,69.11130875403133,91.35806861654343,-8.641931383456573,1.239586303930281,0.8727565073988597,0.04714249236943546,253636500.0,1.0
791,ACGL,2023-04-21,68.16040802001953,68.36960686075872,67.16196164550256,68.36960686075872,1729900.0,-0.48496246337890625,0.48496246337890625,0.0,68.32351534147453,63.88136618220106,69.11130875403133,81.81814195946285,-18.181858040537147,1.2440496002635655,0.9470151259718008,0.04413697412413087,251906600.0,-1.0
792,ACGL,2023-04-24,68.94965362548828,69.59626490842561,68.32205712082265,68.4456785713186,1940200.0,0.78924560546875,0.0,0.78924560546875,74.24579716949418,63.88136618220106,69.59626490842561,88.68551633347138,-11.314483666528623,1.296329044832575,1.0168779097439558,0.050717334977146145,253846800.0,1.0
793,ACGL,2023-04-25,69.02571868896484,69.59626359325371,68.54076567701105,68.74045349160022,1762800.0,0.0760650634765625,0.0,0.0760650634765625,74.77034414160983,63.966943992105975,69.59626490842561,89.86474162795145,-10.135258372048554,1.328583611369595,1.0792190500690837,0.0336037144819854,255609600.0,1.0
794,ACGL,2023-04-26,68.7404556274414,69.58675473904424,68.47420519971648,68.54076780664771,2274900.0,-0.2852630615234375,0.2852630615234375,0.0,68.71426692442691,64.95587317675663,69.59626490842561,81.55739147745616,-18.44260852254384,1.3159577014822474,1.1265667803517165,0.025390099978945813,253334700.0,-1.0
795,ACGL,2023-04-27,70.25238037109375,70.31894297761069,67.55183204408667,69.05425345378892,2265100.0,1.5119247436523438,0.0,1.5119247436523438,79.07770550147514,64.95587317675663,70.31894297761069,98.75887115050529,-1.241128849494726,1.4116783191384314,1.1835890881090596,0.051672563593210485,255599800.0,1.0
796,ACGL,2023-04-28,71.38394927978516,71.69774752230558,69.89103894223074,70.00514937263263,2204700.0,1.1315689086914062,0.0,1.1315689086914062,83.73147158832967,65.088997658491,71.69774752230558,95.2517760698043,-4.748223930195705,1.5608532080907196,1.2590419121053917,0.05806906213049601,257804500.0,1.0
797,ACGL,2023-05-01,72.17320251464844,73.14311585857891,71.21279293292353,71.25082974608674,1890800.0,0.7892532348632812,0.0,0.7892532348632812,86.20154071389186,65.54543756050413,73.14311585857891,87.23408249364489,-12.765917506355109,1.7229009921525176,1.351813728114817,0.05051914150008163,259695300.0,1.0
798,ACGL,2023-05-02,72.29681396484375,72.50601280188941,71.01310240225811,71.70726152020237,1959000.0,0.1236114501953125,0.0,0.1236114501953125,86.57003103411954,65.95432160972082,73.14311585857891,88.22748482654667,-11.772515173453337,1.840088049855808,1.4494685924630155,0.05406903465147472,261654300.0,1.0
799,ACGL,2023-05-03,71.90695190429688,72.72472524838751,71.45051740221687,72.50601538692037,1443800.0,-0.389862060546875,0.389862060546875,0.0,78.90200295360118,66.22057281030993,73.14311585857891,82.14292138506607,-17.85707861493392,1.8798314999232275,1.5355411739550582,0.04751349432497043,260210500.0,-1.0
800,ACGL,2023-05-04,69.33951568603516,71.90694594473666,69.26344206619666,71.66922132382614,3000600.0,-2.5674362182617188,2.5674362182617188,0.0,47.16034133860254,66.22057281030993,73.14311585857891,45.054871511490774,-54.94512848850923,1.6847372225942223,1.5653803836828912,0.017299011262803976,257209900.0,-1.0
801,ACGL,2023-05-05,71.13671875,71.41248020219031,68.84505699939541,69.65331932214342,1901200.0,1.7972030639648438,0.0,1.7972030639648438,60.118842630426094,67.16196164550256,73.14311585857891,66.45468354264456,-33.54531645735543,1.6560529224095006,1.5835148914282133,0.03171974055723514,259111100.0,1.0
802,ACGL,2023-05-08,72.40141296386719,72.64864861119594,71.60266168680816,71.61216544859697,1995700.0,1.2646942138671875,0.0,1.2646942138671875,66.74151821200368,67.16196164550256,73.14311585857891,87.59933503987965,-12.40066496012036,1.715594357588543,1.6099307846602797,0.048904876892531535,261106800.0,1.0
803,ACGL,2023-05-09,72.84833526611328,72.86735004416697,72.13516138523222,72.26828659594763,1686800.0,0.44692230224609375,0.0,0.44692230224609375,68.8506745697557,67.16196164550256,73.14311585857891,95.07150991323445,-4.928490086765549,1.7783446188614107,1.6436135515005061,0.059759272777237804,262793600.0,1.0
804,ACGL,2023-05-10,73.42838287353516,73.52347127198709,72.46797336317715,72.91489681615899,2081600.0,0.580047607421875,0.0,0.580047607421875,71.55234487659465,67.16196164550256,73.52347127198709,98.505254192243,-1.4947458077569924,1.853513497443771,1.6855935406891596,0.045208468178086214,264875200.0,1.0
805,ACGL,2023-05-11,73.51396179199219,73.54248758664592,72.76275109539762,73.21918557419707,1251300.0,0.08557891845703125,0.0,0.08557891845703125,71.96626423643295,67.55183204408667,73.54248758664592,99.52382849504406,-0.4761715049559495,1.8981106408544974,1.7280969607222274,0.029838815779981154,266126500.0,1.0
806,ACGL,2023-05-12,73.12409973144531,74.45535914849609,73.08606291898327,73.97039885808027,1076700.0,-0.389862060546875,0.389862060546875,0.0,66.85317480589538,67.55183204408667,74.45535914849609,80.71624262617189,-19.28375737382811,1.8803204248408747,1.758541653545957,0.013175211625171768,265049800.0,-1.0
807,ACGL,2023-05-15,71.4124755859375,73.19065838486182,71.07015154705603,73.15262157445503,1959200.0,-1.7116241455078125,1.7116241455078125,0.0,49.15982405910351,67.55183204408667,74.45535914849609,55.92276938240691,-44.07723061759308,1.7084142505464968,1.748516172946065,-0.012232051876259531,263090600.0,-1.0
808,ACGL,2023-05-16,70.86095428466797,71.45051397684497,70.5566670494624,71.16524151987353,1952400.0,-0.5515213012695312,0.5515213012695312,0.0,44.75589707317615,67.55183204408667,74.45535914849609,47.93379080771191,-52.06620919228809,1.5102648164476733,1.7008659016463865,-0.014546543719737404,261138200.0,-1.0
809,ACGL,2023-05-17,69.45362854003906,71.08917514975622,69.33001434457158,71.0035905107557,1876200.0,-1.4073257446289062,1.4073257446289062,0.0,35.414851964143494,68.84505699939541,74.45535914849609,10.847393321609342,-89.15260667839065,1.225543236696737,1.6058013686564567,0.0016457117254842224,259262000.0,-1.0
810,ACGL,2023-05-18,71.6026611328125,71.69774953342477,69.14934122120418,69.41559164483051,1739800.0,2.1490325927734375,0.0,2.1490325927734375,52.779677615565596,68.84505699939541,74.45535914849609,49.152506587530766,-50.847493412469234,1.159937268660741,1.5166285486573137,0.0065499560705069015,261001800.0,1.0
811,ACGL,2023-05-19,72.28730010986328,72.92440761260819,71.87841346845076,72.04957548706018,2176000.0,0.6846389770507812,0.0,0.6846389770507812,57.02686418184602,68.84505699939541,74.45535914849609,61.35575266689794,-38.64424733310205,1.149932998213103,1.4432894385684718,-0.0015761136327664405,263177800.0,1.0
812,ACGL,2023-05-22,69.89104461669922,72.52503045300753,69.09229330337435,72.23976523601165,2533100.0,-2.3962554931640625,2.3962554931640625,0.0,41.83190747341488,68.84505699939541,74.45535914849609,18.644051416579742,-81.35594858342026,0.9378359606787825,1.342198742990534,-0.0405951713050291,260644700.0,-1.0
813,ACGL,2023-05-23,69.57723999023438,71.72627258482159,69.33951537040596,69.91005300703823,1735700.0,-0.31380462646484375,0.31380462646484375,0.0,40.212861855978225,68.84505699939541,74.45535914849609,13.050687313807735,-86.94931268619227,0.735942631032998,1.2209475205990268,-0.05244760585199815,258909000.0,-1.0
814,ACGL,2023-05-24,68.24598693847656,69.39658058836531,67.78955968914744,69.11130811644937,1432600.0,-1.3312530517578125,1.3312530517578125,0.0,33.80787215761096,67.78955968914744,74.45535914849609,6.847299444164859,-93.15270055583514,0.4631804611585153,1.0693941087109244,-0.07165951507852841,257476400.0,-1.0
815,ACGL,2023-05-25,68.82603454589844,69.48215686796357,67.95120961966505,68.10335687019966,1677300.0,0.580047607421875,0.0,0.580047607421875,38.715326424118025,67.78955968914744,74.45535914849609,15.549145501180123,-84.45085449881988,0.2904711006106453,0.9136095070908686,-0.05877768343585632,259153700.0,1.0
816,ACGL,2023-05-26,67.5137939453125,68.96866749914389,67.3996835128391,68.82603127224712,1423800.0,-1.3122406005859375,1.3122406005859375,0.0,32.43767285229427,67.3996835128391,74.45535914849609,1.617285691206107,-98.3827143087939,0.047167125198924964,0.7403210307124799,-0.054593845243935624,257729900.0,-1.0
817,ACGL,2023-05-30,67.70397186279297,68.58830777842203,67.54232085520421,67.68495708445664,2109300.0,0.19017791748046875,0.0,0.19017791748046875,34.22126063968844,67.3996835128391,74.45535914849609,4.312674868670195,-95.6873251313298,-0.12882227665168955,0.5664923692396461,-0.04455179095094508,259839200.0,1.0
818,ACGL,2023-05-31,66.27762603759766,68.13188256309193,66.20155966722542,67.70397386269471,2977100.0,-1.4263458251953125,1.4263458251953125,0.0,27.857132036208796,66.20155966722542,74.45535914849609,0.9215921775763956,-99.07840782242361,-0.37902022396730217,0.37738985059825636,-0.04572838841113225,256862100.0,-1.0
819,ACGL,2023-06-01,66.24909973144531,66.50584640066158,65.65954727800671,66.1064634990785,2122900.0,-0.02852630615234375,0.02852630615234375,0.0,27.738093340791664,65.65954727800671,74.45535914849609,6.702649648710585,-93.29735035128942,-0.5730005407427683,0.18731177233005142,-0.07476763177051637,254739200.0,-1.0
820,ACGL,2023-06-02,67.41870880126953,67.53281198447307,66.6770090913257,66.7245496660671,1997400.0,1.1696090698242188,0.0,1.1696090698242188,39.88993376472072,65.65954727800671,73.19065838486182,23.358592089573104,-76.64140791042689,-0.625147352694924,0.02481994732505629,-0.06735057612048578,256736600.0,1.0
821,ACGL,2023-06-05,67.79906463623047,68.2745138770041,67.37115596666641,67.8656272397476,1723900.0,0.3803558349609375,0.0,0.3803558349609375,43.457753963316385,65.65954727800671,72.92440761260819,29.45022009622875,-70.54977990377125,-0.628537154681112,-0.10585147307617743,-0.02993201764176967,258460500.0,1.0
822,ACGL,2023-06-06,67.70397186279297,68.23647996835003,67.45674347052075,68.18893214033922,1439100.0,-0.0950927734375,0.0950927734375,0.0,42.726185107091524,65.65954727800671,72.92440761260819,28.141278574193056,-71.85872142580695,-0.6316159141789228,-0.21100436129672653,-0.026923576268681138,257021400.0,-1.0
823,ACGL,2023-06-07,67.75151824951172,68.02727968559208,67.3045947929256,67.66594086664875,1617500.0,0.04754638671875,0.0,0.04754638671875,43.2770745681915,65.65954727800671,72.92440761260819,28.795749335210903,-71.20425066478909,-0.6230372713785073,-0.2934109433130827,-0.007245388500434546,258638900.0,1.0
824,ACGL,2023-06-08,67.50428771972656,68.08433643010125,67.31411090688715,67.51379873680264,1872800.0,-0.24723052978515625,0.24723052978515625,0.0,40.9158750594357,65.65954727800671,72.92440761260819,25.392648402800226,-74.60735159719977,-0.6289380661886526,-0.36051636788819674,-0.01920416939451064,256766100.0,-1.0
825,ACGL,2023-06-09,67.93218994140625,68.19844035585938,67.1524534756022,67.42821490622286,1591900.0,0.4279022216796875,0.0,0.4279022216796875,46.72111608427885,65.65954727800671,72.52503045300753,33.10244312701657,-66.89755687298343,-0.5922591604934979,-0.40686492640925703,0.006197192775637239,258358000.0,1.0
826,ACGL,2023-06-12,66.99079895019531,67.95120850276338,66.62946011828518,67.7800464761154,1630100.0,-0.9413909912109375,0.9413909912109375,0.0,37.3943885881636,65.65954727800671,71.72627258482159,21.943496777300567,-78.05650322269943,-0.6318694512221867,-0.4518658313718431,-0.010533693858359672,256727900.0,-1.0
827,ACGL,2023-06-13,67.10491180419922,68.30304603390717,66.97178658476282,67.17147441391742,1617700.0,0.11411285400390625,0.0,0.11411285400390625,39.09491000001946,65.65954727800671,69.48215686796357,37.81093758541059,-62.189062414589415,-0.6465993436249988,-0.49081253382247425,0.012482127318987901,258345600.0,1.0
828,ACGL,2023-06-14,66.63896942138672,67.56134213822787,66.38222276062686,67.02883403858293,1824100.0,-0.4659423828125,0.4659423828125,0.0,34.65947355196535,65.65954727800671,69.48215686796357,25.621819867591043,-74.37818013240896,-0.6879403970581137,-0.5302381064696021,0.00588490547829057,256521500.0,-1.0
829,ACGL,2023-06-15,66.70553588867188,67.14294835867342,66.07793935250858,66.33468602813187,1852200.0,0.06656646728515625,0.0,0.06656646728515625,35.859035902500366,65.65954727800671,68.96866749914389,31.60926593068017,-68.39073406931982,-0.7071801891432727,-0.5656265230043362,-0.010578264183312647,258373700.0,1.0
830,ACGL,2023-06-16,67.66593933105469,67.9607155383773,67.02883183570952,67.24754167825124,3297800.0,0.9604034423828125,0.0,0.9604034423828125,50.873295872388105,65.65954727800671,68.58830777842203,68.50652529503358,-31.493474704966413,-0.6375816868074509,-0.5800175557649592,-0.001963527165014023,261671500.0,1.0
831,ACGL,2023-06-20,67.3141098022461,68.21746053057963,66.74357211831017,67.69447067646347,1751900.0,-0.35182952880859375,0.35182952880859375,0.0,46.292839475416024,65.65954727800671,68.30304603390717,62.58987338451721,-37.41012661548279,-0.6038532307306923,-0.5847846907581058,-0.0057583336667006435,259919600.0,-1.0
832,ACGL,2023-06-21,68.24598693847656,68.44568202168593,67.2475477963314,67.57084982670784,2598800.0,0.9318771362304688,0.0,0.9318771362304688,57.88218660219313,65.65954727800671,68.44568202168593,92.83254036214856,-7.167459637851435,-0.4962085066324562,-0.5670694539329759,0.007298267282274562,262518400.0,1.0
833,ACGL,2023-06-22,69.04474639892578,69.09229422978613,68.08433680283409,68.63585971978024,1606100.0,0.7987594604492188,0.0,0.7987594604492188,65.28995254574718,66.07793935250858,69.09229422978613,98.42262000341194,-1.5773799965880613,-0.34249797088850187,-0.5221551573240811,0.022820160485139906,264124500.0,1.0
834,ACGL,2023-06-23,68.85456848144531,69.55823138726153,68.38862296177945,68.89259803978756,3031700.0,-0.19017791748046875,0.19017791748046875,0.0,62.28064538026222,66.07793935250858,69.55823138726153,79.78149825389103,-20.218501746108963,-0.23333726569281055,-0.464391578997827,0.013577930298355634,261092800.0,-1.0
835,ACGL,2023-06-26,67.72299194335938,69.33951648220021,67.6088815122914,68.79750463049196,1374300.0,-1.1315765380859375,1.1315765380859375,0.0,47.309886227205155,66.07793935250858,69.55823138726153,47.26765956488392,-52.732340435116086,-0.23542159639031013,-0.4185975824763236,0.010929754602694297,259718500.0,-1.0
836,ACGL,2023-06-27,67.64691925048828,68.72143195235881,67.59937142319619,68.16991633158183,1589400.0,-0.07607269287109375,0.07607269287109375,0.0,46.44389769399185,66.07793935250858,69.55823138726153,45.08184607246836,-54.918153927531634,-0.24044022874541326,-0.38296611173014156,0.008077015999522486,258129100.0,-1.0
837,ACGL,2023-06-28,68.16040802001953,68.27451845718095,67.0668732419248,67.87513555450606,1646800.0,0.51348876953125,0.0,0.51348876953125,53.1263932196378,66.07793935250858,69.55823138726153,59.836032342003655,-40.163967657996345,-0.20067007898984457,-0.3465069051820822,0.022831064343328933,259775900.0,1.0
838,ACGL,2023-06-29,69.4441146850586,69.4631367172945,68.169914206879,68.52174200066727,925500.0,1.2837066650390625,0.0,1.2837066650390625,65.53222140112803,66.07793935250858,69.55823138726153,96.72105958168434,-3.2789404183156616,-0.06482034075668253,-0.2901695922970023,0.04105474545556853,260701400.0,1.0
839,ACGL,2023-06-30,71.17475128173828,71.85939936257707,69.99563917294917,69.99563917294917,2046300.0,1.7306365966796875,0.0,1.7306365966796875,75.58427848460182,66.07793935250858,71.85939936257707,88.15786877974662,-11.842131220253371,0.18040981332926265,-0.19605371117174927,0.05185492118149404,262747700.0,1.0
840,ACGL,2023-07-03,70.35697937011719,70.78488805641744,69.42510288443032,70.77537703989168,808300.0,-0.8177719116210938,0.8177719116210938,0.0,65.2146945936947,66.07793935250858,71.85939936257707,74.01313872545353,-25.98686127454647,0.3052503819757959,-0.09579289254224023,0.04520403785789284,261939400.0,-1.0
841,ACGL,2023-07-05,70.0051498413086,70.09072722359815,68.77848991169986,69.77692897897688,1269600.0,-0.35182952880859375,0.35182952880859375,0.0,61.05645556158188,66.07793935250858,71.85939936257707,67.92765982919067,-32.07234017080932,0.37151513423577853,-0.002331287186636456,0.02577679628866547,260669800.0,-1.0
842,ACGL,2023-07-06,70.24287414550781,70.72782715250138,69.78643967770122,70.01465328421465,1545900.0,0.23772430419921875,0.0,0.23772430419921875,62.90070171421845,66.07793935250858,71.85939936257707,72.03949842679785,-27.96050157320216,0.43816193438429707,0.08576735712755028,0.017352916899129545,262215700.0,1.0
843,ACGL,2023-07-07,71.1176986694336,71.5931479126403,69.86251295755906,70.05268975292987,1721700.0,0.8748245239257812,0.0,0.8748245239257812,69.11183429106973,66.74357211831017,71.85939936257707,85.50184246399904,-14.49815753600096,0.5551713616584522,0.1796481580337307,0.032868264777494716,263937400.0,1.0
844,ACGL,2023-07-10,71.0416259765625,71.79283666120698,70.66126512607696,71.10818858128899,1742300.0,-0.07607269287109375,0.07607269287109375,0.0,67.97006453738909,66.74357211831017,71.85939936257707,84.01483578377258,-15.985164216227417,0.6344501982777331,0.2706085660825312,0.04900306288857825,262195100.0,-1.0
845,ACGL,2023-07-11,72.19221496582031,72.3158364183093,71.06065064352161,71.06065064352161,1544400.0,1.1505889892578125,0.0,1.1505889892578125,75.13809506545421,67.0668732419248,72.3158364183093,97.64484054593538,-2.3551594540646192,0.7811179218572448,0.372710437237474,0.0671914665988167,263739500.0,1.0
846,ACGL,2023-07-12,72.62962341308594,72.80078542996559,72.22073677580563,72.44895763483161,1968200.0,0.437408447265625,0.0,0.437408447265625,77.3605106249182,67.0668732419248,72.80078542996559,97.01491736764577,-2.98508263235424,0.9220198843084546,0.4825723266516702,0.06556908215328972,265707700.0,1.0
847,ACGL,2023-07-13,73.1050796508789,73.18115327783535,71.9640042656537,72.04958165489442,2789300.0,0.47545623779296875,0.0,0.47545623779296875,79.64284485755155,67.0668732419248,73.18115327783535,98.75580401110767,-1.2441959888923242,1.0598339435536133,0.598024650032059,0.05271814584178136,268497000.0,1.0
848,ACGL,2023-07-14,73.21918487548828,73.38083588017012,72.59158837997548,73.3332953077942,1565000.0,0.114105224609375,0.0,0.114105224609375,80.19570451692645,67.0668732419248,73.38083588017012,97.4397852197813,-2.560214780218698,1.1648324529760288,0.7113862106208529,0.028724141032222317,270062000.0,1.0
849,ACGL,2023-07-17,76.65193176269531,77.39363146190077,73.51396368398595,73.53298571743127,3621100.0,3.4327468872070312,0.0,3.4327468872070312,89.80588452808591,67.0668732419248,77.39363146190077,92.81769086284291,-7.182309137157089,1.5076591570246336,0.8706407999016093,0.08947161246737356,273683100.0,1.0
850,ACGL,2023-07-18,76.87063598632812,77.33658150343177,76.28108352312145,76.45224555384152,3113800.0,0.2187042236328125,0.0,0.2187042236328125,90.15701010005594,67.0668732419248,77.39363146190077,94.93553093398695,-5.064469066013046,1.7765207674148797,1.0518167934042633,0.0980711584873768,276796900.0,1.0
851,ACGL,2023-07-19,76.30960845947266,76.9752345410077,75.9863064355214,76.09089860137962,2648700.0,-0.5610275268554688,0.5610275268554688,0.0,81.81587078341313,68.169914206879,77.39363146190077,88.24743893967559,-11.752561060324403,1.9221677447246037,1.2258869836683315,0.08636796810730774,274148200.0,-1.0
852,ACGL,2023-07-20,77.49822998046875,77.73595461231068,76.72800449483051,76.92769231500412,2750100.0,1.1886215209960938,0.0,1.1886215209960938,85.16996574380872,68.77848991169986,77.73595461231068,97.34607235654842,-2.6539276434515853,2.1091923896509996,1.4025480648648652,0.08971791031502407,276898300.0,1.0
853,ACGL,2023-07-21,78.23041534423828,78.46813996602125,76.984740647625,77.86907653084886,8069200.0,0.7321853637695312,0.0,0.7321853637695312,86.88885825166591,68.77848991169986,78.46813996602125,97.54661292770884,-2.453387072291152,2.290093238601713,1.580057099612235,0.1011912279435645,284967500.0,1.0
854,ACGL,2023-07-24,77.20345306396484,78.20189215585063,77.12737944131261,77.94515274787427,1925200.0,-1.0269622802734375,1.0269622802734375,0.0,73.16459889742076,68.77848991169986,78.46813996602125,86.94806422351253,-13.05193577648747,2.3238038273748884,1.728806445164766,0.06941521465322986,283042300.0,-1.0
855,ACGL,2023-07-25,77.36510467529297,77.60282930685304,76.68045657563515,76.91818120719523,2116500.0,0.161651611328125,0.0,0.161651611328125,73.91297989422127,69.78643967770122,78.46813996602125,87.29470893838318,-12.705291061616816,2.3366284476606722,1.8503708456639472,0.065200410516707,285158800.0,1.0
856,ACGL,2023-07-26,78.04975128173828,78.79145095725106,77.29854058980668,77.29854058980668,2488300.0,0.6846466064453125,0.0,0.6846466064453125,77.04183950042102,69.86251295755906,78.79145095725106,91.69330467365367,-8.306695326346334,2.3746636663741043,1.955229409805979,0.06763786667729765,287647100.0,1.0
857,ACGL,2023-07-27,75.75808715820312,80.66472725052213,75.64398397312243,80.63620145425196,3504200.0,-2.2916641235351562,2.2916641235351562,0.0,52.65200205078172,70.66126512607696,80.66472725052213,50.950580596203885,-49.049419403796115,2.1945908316781413,2.003101694180412,0.034675369399868705,284142900.0,-1.0
858,ACGL,2023-07-28,73.4569091796875,76.0718800566343,73.12409615539569,76.05286527872326,2070500.0,-2.301177978515625,2.301177978515625,0.0,38.52209487290247,71.06065064352161,80.66472725052213,24.950431303507383,-75.04956869649261,1.8449287910327286,1.9714671135508752,-0.04168221869344657,282072400.0,-1.0
859,ACGL,2023-07-31,73.87530517578125,74.20811819256876,73.34279709414157,73.4569075233743,2035100.0,0.41839599609375,0.0,0.41839599609375,41.798830106872416,71.9640042656537,80.66472725052213,21.967150470731276,-78.03284952926872,1.5833285390355911,1.8938393986478186,-0.03896586482099107,284107500.0,1.0
860,ACGL,2023-08-01,73.31427764892578,74.45536027572207,73.09557504243318,73.95137794405505,1462400.0,-0.5610275268554688,0.5610275268554688,0.0,38.61450554906117,71.9640042656537,80.66472725052213,15.519094052532923,-84.48090594746708,1.3155731139435431,1.7781861417069633,-0.03925234149429124,282645100.0,-1.0
861,ACGL,2023-08-02,73.56150817871094,74.31271886059112,73.02900734285856,73.2286951563032,1495300.0,0.24723052978515625,0.0,0.24723052978515625,40.90368295753209,72.59158837997548,80.66472725052213,12.014159725085772,-87.98584027491422,1.1105230298349937,1.6446535193325693,-0.05079757050902911,284140400.0,1.0
862,ACGL,2023-08-03,73.59003448486328,73.96088432023805,72.6106101886284,73.0385116125901,1815700.0,0.02852630615234375,0.0,0.02852630615234375,41.19563706412823,72.6106101886284,80.66472725052213,12.16054210173838,-87.83945789826161,0.9394913242027201,1.5036210803065997,-0.059316837817565915,285956100.0,1.0
863,ACGL,2023-08-04,72.95293426513672,73.78972233553077,72.83882383312759,73.41887249997592,1582100.0,-0.6371002197265625,0.6371002197265625,0.0,36.543291577129395,72.6106101886284,80.66472725052213,4.25029924295426,-95.74970075704574,0.7439628612453788,1.3516894364943557,-0.05505607107115362,284374000.0,-1.0
864,ACGL,2023-08-07,74.3887939453125,74.72160697426989,73.76119744375292,73.76119744375292,1570500.0,1.4358596801757812,0.0,1.4358596801757812,50.94864444582089,72.6106101886284,80.66472725052213,22.077947750439115,-77.92205224956089,0.6968343492415983,1.2207184190438043,-0.038470971408521515,285944500.0,1.0
865,ACGL,2023-08-08,72.60110473632812,74.34125086939068,72.4489647368432,73.71365432771681,1450300.0,-1.787689208984375,1.787689208984375,0.0,38.419400417503674,72.4489647368432,80.66472725052213,1.8518061985314564,-98.14819380146854,0.5093614830035023,1.078447031835744,-0.06980991554658555,284494200.0,-1.0
866,ACGL,2023-08-09,73.26673126220703,73.61855905903522,72.12564872592124,72.52502434897039,1604800.0,0.6656265258789062,0.0,0.6656265258789062,44.30382638040113,72.12564872592124,80.66472725052213,13.363064094074788,-86.63693590592521,0.40977475530299046,0.9447125765291933,-0.03288567583277913,286099000.0,1.0
867,ACGL,2023-08-10,72.81980895996094,74.23664569535062,72.66766171748105,73.51396080313086,1048900.0,-0.44692230224609375,0.44692230224609375,0.0,41.250071272031846,72.12564872592124,80.66472725052213,8.129217128520828,-91.87078287147918,0.2914292464661088,0.8140559105165763,-0.00867311498457024,285050100.0,-1.0
868,ACGL,2023-08-11,72.83882904052734,73.00999107338784,72.41092758576629,72.79128846487632,1028100.0,0.01902008056640625,0.0,0.01902008056640625,41.4482518396053,72.12564872592124,80.66472725052213,8.35195873362037,-91.64804126637964,0.1969045465796455,0.6906256377291903,-0.01403007585265037,286078200.0,1.0
869,ACGL,2023-08-14,73.552001953125,73.77071181339817,72.30632716464373,72.89588688186599,1346900.0,0.7131729125976562,0.0,0.7131729125976562,48.905195468124944,72.12564872592124,80.66472725052213,16.70383078331544,-83.29616921668456,0.17749409329655919,0.587999328842664,0.003242537631449993,287425100.0,1.0
870,ACGL,2023-08-15,73.56150817871094,73.80874381883373,73.02900734285856,73.18114732962505,1563500.0,0.0095062255859375,0.0,0.0095062255859375,49.0050824913087,72.12564872592124,80.66472725052213,16.81515691245865,-83.18484308754135,0.1610220798788191,0.502603879049895,0.0,288988600.0,1.0
871,ACGL,2023-08-16,73.17163848876953,74.1320480289395,73.07655008736597,73.69463557865912,1195300.0,-0.38986968994140625,0.38986968994140625,0.0,44.85547471233747,72.12564872592124,76.0718800566343,26.50604273265676,-73.49395726734325,0.11518093079691027,0.42511928939929805,-0.005685498030033043,287793300.0,-1.0
872,ACGL,2023-08-17,70.64225006103516,73.77070698002196,70.62322802845931,73.77070698002196,2223800.0,-2.529388427734375,2.529388427734375,0.0,27.453277504317413,70.62322802845931,74.72160697426989,0.4641355235169757,-99.53586447648303,-0.12382167802724098,0.3153310959139902,-0.031673629407471426,285569500.0,-1.0
873,ACGL,2023-08-18,71.54560089111328,72.12564955473191,69.89103953748264,70.2238525605147,2468500.0,0.903350830078125,0.0,0.903350830078125,37.452920439808224,69.89103953748264,74.72160697426989,34.251904673357984,-65.74809532664202,-0.2376011864954677,0.2047446394320986,-0.038220717172661955,288038000.0,1.0
874,ACGL,2023-08-21,71.26984405517578,71.9830179740259,70.11925767000457,71.9354773989707,1212500.0,-0.2757568359375,0.2757568359375,0.0,35.7187922134582,69.89103953748264,74.72160697426989,28.543324065674707,-71.4566759343253,-0.3460346665211915,0.09458877824144057,-0.01833664495860221,286825500.0,-1.0
875,ACGL,2023-08-22,70.90850067138672,71.31738731552022,70.65176126915395,71.05113689697372,854600.0,-0.3613433837890625,0.3613433837890625,0.0,33.38185164105239,69.89103953748264,74.72160697426989,21.06297339222696,-78.93702660777305,-0.4558713704730053,-0.015503251501448628,-0.03218692236153775,285970900.0,-1.0
876,ACGL,2023-08-23,71.69775390625,72.04007797315639,70.86095851835424,70.86095851835424,1316000.0,0.7892532348632812,0.0,0.7892532348632812,42.81165435589247,69.89103953748264,74.72160697426989,37.4017005747255,-62.5982994252745,-0.4737702808111379,-0.10715665736338653,-0.015408651433401643,287286900.0,1.0
877,ACGL,2023-08-24,71.70726013183594,72.50601139805791,71.2318108767667,71.28886246584545,1189800.0,0.0095062255859375,0.0,0.0095062255859375,42.92393469813917,69.89103953748264,74.72160697426989,37.59849371984429,-62.401506280155715,-0.481636220706676,-0.18205257003204445,-0.015535242996037257,288476700.0,1.0
878,ACGL,2023-08-25,70.95604705810547,71.89743452022631,70.8324256128751,71.76430931365486,1262400.0,-0.7512130737304688,0.7512130737304688,0.0,36.40648264419209,69.89103953748264,74.34125086939068,23.931616752371262,-76.06838324762873,-0.542236091512649,-0.2540892743281654,-0.035294143273951195,287214300.0,-1.0
879,ACGL,2023-08-28,70.54716491699219,71.73578809052404,70.2618924534325,70.71832694417198,1740100.0,-0.40888214111328125,0.40888214111328125,0.0,33.2370355123834,69.89103953748264,74.23664569535062,15.098592823962958,-84.90140717603704,-0.616152672870939,-0.32650195403672017,-0.040977181359518666,285474200.0,-1.0
880,ACGL,2023-08-29,72.03056335449219,72.30632479764404,70.36649093376134,70.62323034371376,2394900.0,1.4833984375,0.0,1.4833984375,51.06891791809806,69.89103953748264,74.23664569535062,49.234185963581,-50.765814036419,-0.5487090629907385,-0.3709433758275239,-0.01559450024414144,287869100.0,1.0
881,ACGL,2023-08-30,73.30476379394531,73.65659885983928,72.1541774495202,72.23976208923712,1779900.0,1.274200439453125,0.0,1.274200439453125,61.31078876230801,69.89103953748264,74.1320480289395,80.49321908549172,-19.506780914508283,-0.3879699140628077,-0.3743486834745807,0.03769010373550863,289649000.0,1.0
882,ACGL,2023-08-31,73.0860595703125,73.54248678938399,72.7056987178997,73.380835784912,2148500.0,-0.2187042236328125,0.2187042236328125,0.0,58.870401232924614,69.89103953748264,74.1320480289395,75.33632717939501,-24.663672820604994,-0.2750598646334197,-0.35449091970634855,0.02153114461284167,287500500.0,-1.0
883,ACGL,2023-09-01,73.22869873046875,73.91334684128387,73.1526251059826,73.61856336009505,880200.0,0.14263916015625,0.0,0.14263916015625,60.06655812527647,69.89103953748264,74.1320480289395,78.69965834092379,-21.30034165907621,-0.1720843673798811,-0.3180096092410551,0.02748504225400672,288380700.0,1.0
884,ACGL,2023-09-05,72.13516235351562,73.26673391456576,71.96400032961543,73.07654985757668,1285200.0,-1.093536376953125,1.093536376953125,0.0,47.77567983463645,69.89103953748264,74.1320480289395,52.91483901891677,-47.08516098108323,-0.17667815467460457,-0.289743318327765,0.017299219000746602,287095500.0,-1.0
885,ACGL,2023-09-06,72.68668365478516,73.26673232011372,71.98301354140898,72.24927121539932,922800.0,0.5515213012695312,0.0,0.5515213012695312,53.332675257269166,69.89103953748264,73.91334684128387,69.50349404334496,-30.496505956655035,-0.1342678482694879,-0.25864822431610957,0.013793036666507774,288018300.0,1.0
886,ACGL,2023-09-07,74.04647064208984,74.27468425640816,72.58208604521897,72.58208604521897,2216700.0,1.3597869873046875,0.0,1.3597869873046875,64.17667759071676,69.89103953748264,74.27468425640816,94.79397558536043,-5.206024414639568,0.008962753722016714,-0.2051260287084843,0.032621669074417214,290235000.0,1.0
887,ACGL,2023-09-08,73.46642303466797,74.01793867275566,72.86735231301567,73.97990911546418,1330100.0,-0.580047607421875,0.580047607421875,0.0,57.59002673506514,70.11925767000457,74.27468425640816,80.54925998729475,-19.45074001270526,0.07480671818061069,-0.1491394793306653,0.03537930987765936,288904900.0,-1.0
888,ACGL,2023-09-11,74.9308090209961,74.949823799989,73.72316379370956,73.72316379370956,1387900.0,1.464385986328125,0.0,1.464385986328125,67.35106929358581,70.2618924534325,74.949823799989,99.59438870607867,-0.40561129392132755,0.24235848732755016,-0.07083988599902218,0.062137778451647696,290292800.0,1.0
889,ACGL,2023-09-12,74.9308090209961,76.32862380255244,74.68357336540684,75.04491220451402,1167200.0,0.0,0.0,0.0,67.35106929358581,70.2618924534325,76.32862380255244,76.95934266548463,-23.040657334515373,0.3708693208491951,0.017501955370621308,0.04026409806390929,290292800.0,1.0
890,ACGL,2023-09-13,74.48388671875,75.47282210198426,74.2461620762835,74.94982498664584,952400.0,-0.44692230224609375,0.44692230224609375,0.0,61.591120902536005,70.2618924534325,76.32862380255244,69.59257007366836,-30.40742992633165,0.43167609427416664,0.1003367831513304,0.01608521552731723,289340400.0,-1.0
891,ACGL,2023-09-14,75.17803192138672,75.43477857507762,74.60749428119986,75.00686990385269,1222100.0,0.6941452026367188,0.0,0.6941452026367188,66.69550305150699,70.2618924534325,76.32862380255244,81.03440197112683,-18.965598028873178,0.5297707495123518,0.18622357642353474,0.028623411405312327,290562500.0,1.0
892,ACGL,2023-09-15,75.12098693847656,75.47282202066883,74.74062605998391,75.14000171775004,1964000.0,-0.05704498291015625,0.05704498291015625,0.0,65.86549077720139,70.2618924534325,76.32862380255244,80.09411008036375,-19.90588991963625,0.596037665953844,0.2681863943295967,0.025840800680791975,288598500.0,-1.0
893,ACGL,2023-09-18,76.6138916015625,76.87063100361074,75.18754385627727,75.30165428762082,1214000.0,1.4929046630859375,0.0,1.4929046630859375,75.1892395780804,70.36649093376134,76.87063100361074,96.05267722879492,-3.947322771205085,0.7602558480735127,0.36660028507837994,0.062088017853176636,289812500.0,1.0
894,ACGL,2023-09-19,77.21295928955078,77.36510653971023,76.32862334864454,76.68996944038312,1572400.0,0.5990676879882812,0.0,0.5990676879882812,77.97477669239215,71.96400032961543,77.36510653971023,97.18303539606242,-2.8169646039375733,0.9280418080572304,0.4788885896741501,0.06227104343159362,291384900.0,1.0
895,ACGL,2023-09-20,77.32706451416016,78.14483779168643,77.022777289135,77.57430015161174,2107300.0,0.114105224609375,0.0,0.114105224609375,78.50514901719312,71.96400032961543,78.14483779168643,86.7692156193303,-13.230784380669702,1.0580244805710777,0.5947157678535357,0.04430452719248912,293492200.0,1.0
896,ACGL,2023-09-21,76.34764099121094,77.52675309300986,76.31911519714174,77.02277805170789,1675400.0,-0.9794235229492188,0.9794235229492188,0.0,63.38770219323955,71.96400032961543,78.14483779168643,70.92308588433083,-29.076914115669172,1.0696748463159196,0.6897075835460126,0.03921816031771885,291816800.0,-1.0
897,ACGL,2023-09-22,76.9847412109375,77.64086349338899,76.31911516698653,76.34764096104446,1559900.0,0.6371002197265625,0.0,0.6371002197265625,68.01113239015149,71.96400032961543,78.14483779168643,81.23075411919638,-18.769245880803616,1.1174354085578386,0.7752531485483779,0.027411050498145295,293376700.0,1.0
898,ACGL,2023-09-25,77.16542053222656,77.35559734462439,76.4807723999458,76.67094921234364,1358000.0,0.1806793212890625,0.0,0.1806793212890625,69.28053551167304,71.98301354140898,78.14483779168643,84.10507635923298,-15.894923640767015,1.156533511060374,0.8515092210507773,0.029822332634955595,294734700.0,1.0
899,ACGL,2023-09-26,77.27001953125,78.11631867490057,76.95622126321409,77.02278387266593,1430700.0,0.1045989990234375,0.0,0.1045989990234375,70.07380220878333,72.58208604521897,78.14483779168643,84.27364188970023,-15.726358110299781,1.1823301381732279,0.9176734044752674,0.03740584622040988,296165400.0,1.0
900,ACGL,2023-09-27,77.0988540649414,77.46019289233064,76.30960654889597,77.26050507286975,1687800.0,-0.17116546630859375,0.17116546630859375,0.0,66.81601525982846,72.86735231301567,78.14483779168643,80.18026329068225,-19.81973670931775,1.175413097850452,0.9692213431503044,0.025550311633101508,294477600.0,-1.0
901,ACGL,2023-09-28,77.63135528564453,78.07827875480024,77.1368912429323,77.34608282518514,1466600.0,0.532501220703125,0.0,0.532501220703125,71.56192578583013,73.72316379370956,78.14483779168643,88.3871468978301,-11.612853102169893,1.1990774730627578,1.0151925691327952,0.03341766994121009,295944200.0,1.0
902,ACGL,2023-09-29,75.7961196899414,77.79300511863768,75.56790607789095,77.70742773466124,3340700.0,-1.835235595703125,1.835235595703125,0.0,45.61759322186079,74.2461620762835,78.14483779168643,39.75600246859004,-60.24399753140997,1.0575526770839758,1.0236645907230313,-0.010673937774548614,292603500.0,-1.0
903,ACGL,2023-10-02,75.47281646728516,76.26205670771725,74.7881683873317,75.82464426880917,1495900.0,-0.32330322265625,0.32330322265625,0.0,42.486623835071384,74.2461620762835,78.14483779168643,31.46336039582312,-68.53663960417687,0.9088289738450044,1.0006974673474258,-0.022536926939168866,291107600.0,-1.0
904,ACGL,2023-10-03,74.13204956054688,75.5869231709418,73.39034985758319,75.3682205686731,1631900.0,-1.3407669067382812,1.3407669067382812,0.0,31.982678723823227,73.39034985758319,78.14483779168643,15.599991276528094,-84.40000872347191,0.6749947639453779,0.9355569266670162,-0.041318197886953345,289475700.0,-1.0
905,ACGL,2023-10-04,76.50929260253906,76.77554302234192,74.43633357792847,74.46485937222451,1608200.0,2.3772430419921875,0.0,2.3772430419921875,54.82941423977863,73.39034985758319,78.14483779168643,65.59997181997579,-34.40002818002421,0.673736696702079,0.8831928806740288,0.0021173098373363786,291083900.0,1.0
906,ACGL,2023-10-05,77.63135528564453,77.79300629434084,76.73750834733313,76.91818138927609,1680600.0,1.1220626831054688,0.0,1.1220626831054688,61.814810143460704,73.39034985758319,78.14483779168643,89.20004607943662,-10.799953920563393,0.7545823942754168,0.8574707833943065,0.008399249832318212,292764500.0,1.0
907,ACGL,2023-10-06,78.14484405517578,78.50618289673663,77.28903389907873,77.41265535510293,1672600.0,0.51348876953125,0.0,0.51348876953125,64.69752811657989,73.39034985758319,78.50618289673663,92.93685234065721,-7.063147659342782,0.8502858780430387,0.8560338023240529,0.012692518438879974,294437100.0,1.0
908,ACGL,2023-10-09,78.04024505615234,78.21140708829971,77.20345692942094,77.87859404100769,1174000.0,-0.1045989990234375,0.1045989990234375,0.0,63.569549616733916,73.39034985758319,78.50618289673663,90.89223911299906,-9.107760887000937,0.9072332927190274,0.8662737004030479,0.009967973731271673,293263100.0,-1.0
909,ACGL,2023-10-10,77.8405532836914,78.40157992715994,77.18443098457467,78.25895095324756,1526000.0,-0.1996917724609375,0.1996917724609375,0.0,61.21842402412214,73.39034985758319,78.50618289673663,86.9888323572934,-13.011167642706594,0.925581544103963,0.878135269143231,0.009620106910087856,291737100.0,-1.0
910,ACGL,2023-10-11,78.94359588623047,79.0291805297961,77.64086949174089,77.97368253942872,1480300.0,1.1030426025390625,0.0,1.1030426025390625,68.61635256567125,73.39034985758319,79.0291805297961,98.48222710450644,-1.517772895493558,1.017401019390391,0.905988419192663,0.016903486944901847,293217400.0,1.0
911,ACGL,2023-10-12,78.97212219238281,79.59971142088125,78.02122370604361,79.16229898773878,1608100.0,0.02852630615234375,0.0,0.02852630615234375,68.79398576580945,73.39034985758319,79.59971142088125,89.8928541670378,-10.107145832962203,1.0800206438874653,0.9407948641316235,0.04190191418021727,294825500.0,1.0
912,ACGL,2023-10-13,80.02762603759766,80.31289125182303,79.08623124274725,79.55217675910845,1961900.0,1.0555038452148438,0.0,1.0555038452148438,74.86725839987442,73.39034985758319,80.31289125182303,95.87918369888345,-4.120816301116545,1.2009734126257996,0.9928305738304587,0.06035033252385458,296787400.0,1.0
913,ACGL,2023-10-16,81.49200439453125,82.15763774515337,80.41749162416372,80.83588931571016,2134600.0,1.4643783569335938,0.0,1.4643783569335938,80.83735457390037,73.39034985758319,82.15763774515337,92.4077621362723,-7.592237863727706,1.398867178285883,1.0740378947215437,0.09928168555454797,298922000.0,1.0
914,ACGL,2023-10-17,82.36683654785156,82.86130061096397,81.2447759477477,81.2447759477477,1935600.0,0.8748321533203125,0.0,0.8748321533203125,83.53360022801996,73.39034985758319,82.86130061096397,94.77915073166336,-5.220849268336633,1.607757825397968,1.1807818808568287,0.07655990202055674,300857600.0,1.0
915,ACGL,2023-10-18,81.25428009033203,83.21313608226053,81.13066588767038,82.49045113607,2029200.0,-1.1125564575195312,1.1125564575195312,0.0,69.2382361930823,73.39034985758319,83.21313608226053,80.05804109828476,-19.941958901715235,1.6643456198244166,1.2774946286503464,0.046668318379306184,298828400.0,-1.0
916,ACGL,2023-10-19,79.66627502441406,82.12910590742251,79.656764008093,81.28280682434334,1736100.0,-1.5880050659179688,1.5880050659179688,0.0,54.01447643098353,73.39034985758319,83.21313608226053,63.891497007887125,-36.108502992112875,1.5630354179505446,1.3346027865103862,0.01946937110993585,297092300.0,-1.0
917,ACGL,2023-10-20,78.69636535644531,80.06565432348667,77.74546681457596,79.83744070477647,5433600.0,-0.96990966796875,0.96990966796875,0.0,46.76763662403166,73.39034985758319,83.21313608226053,54.01741804715306,-45.98258195284694,1.388477247323081,1.3453776786729252,0.00840746078924881,291658700.0,-1.0
918,ACGL,2023-10-23,77.8405532836914,79.57118829670107,77.8405532836914,79.10525005410076,1183700.0,-0.8558120727539062,0.8558120727539062,0.0,41.14715730155693,74.43633357792847,83.21313608226053,38.78655927466387,-61.21344072533612,1.1676221363574086,1.309826570209822,0.0,290475000.0,-1.0
919,ACGL,2023-10-24,79.3239517211914,79.64726098609117,78.2494390198884,78.30649060878488,1334100.0,1.4833984375,0.0,1.4833984375,52.5516582385284,76.73750834733313,83.21313608226053,39.94119921236131,-60.05880078763869,1.0996150485767942,1.2677842658832166,0.004818070809810671,291809100.0,1.0
920,ACGL,2023-10-25,79.39051818847656,81.33035210789943,79.1813193459731,79.27641500513302,1387200.0,0.06656646728515625,0.0,0.06656646728515625,53.0230040805519,77.18443098457467,83.21313608226053,36.59305220865261,-63.40694779134739,1.039112062109595,1.2220498251284924,0.005298021434380296,293196300.0,1.0
921,ACGL,2023-10-26,78.40158081054688,80.27485207335587,78.22091502329557,79.48560455317482,1735000.0,-0.9889373779296875,0.9889373779296875,0.0,45.30771822929549,77.18443098457467,83.21313608226053,20.189241408398093,-79.81075859160191,0.9009781130812513,1.1578354827190442,-0.02031854882571238,291461300.0,-1.0
922,ACGL,2023-10-27,77.36510467529297,78.1638559550404,77.03229164206486,78.04024175834998,1360200.0,-1.0364761352539062,1.0364761352539062,0.0,38.52812034578988,77.03229164206486,83.21313608226053,5.384588407754365,-94.61541159224564,0.6998040953541107,1.0662292052460576,-0.0506417746121266,290101100.0,-1.0
923,ACGL,2023-10-30,78.81047058105469,79.04819522268347,77.8215352013053,77.99269723346923,1740900.0,1.4453659057617188,0.0,1.4453659057617188,50.456574845776046,77.03229164206486,83.21313608226053,28.769190944620053,-71.23080905537994,0.6495139930890019,0.9828861628146465,-0.043177158621732215,291842000.0,1.0
924,ACGL,2023-10-31,82.42388153076172,83.20361800357546,80.82637177490187,81.02605958753689,2964500.0,3.6134109497070312,0.0,3.6134109497070312,68.23633109474842,77.03229164206486,83.21313608226053,87.23063556872451,-12.769364431275484,0.8909603534780075,0.9645010009473187,0.014394336386088336,294806500.0,1.0
925,ACGL,2023-11-01,85.58086395263672,86.19894942102837,82.77571631387886,82.9658931096395,4031500.0,3.156982421875,0.0,3.156982421875,76.67486008180425,77.03229164206486,86.19894942102837,93.25724289816847,-6.742757101831535,1.3218133891063815,1.0359634785791314,0.07424206700275748,298838000.0,1.0
926,ACGL,2023-11-02,81.72022247314453,85.8566296521574,80.92146393073386,85.27658096504372,3406800.0,-3.8606414794921875,3.8606414794921875,0.0,55.769135868965556,77.03229164206486,86.19894942102837,51.141113196545454,-48.858886803454546,1.33634150823913,1.0960390845111312,0.03842435547058676,295431200.0,-1.0
927,ACGL,2023-11-03,81.34937286376953,82.66161023506872,80.0276244757477,82.19567198258119,2658800.0,-0.370849609375,0.370849609375,0.0,54.13321495202037,77.03229164206486,86.19894942102837,47.09547717175504,-52.90452282824495,1.3029115300797258,1.13741357362485,0.04507701232916683,292772400.0,-1.0
928,ACGL,2023-11-06,80.97852325439453,81.72972671776856,80.35092673488089,81.58709774040649,2864300.0,-0.370849609375,0.370849609375,0.0,52.36096908339749,77.03229164206486,86.19894942102837,43.04984114696464,-56.95015885303536,1.2322885124824126,1.1563885613963627,0.020858410319982923,289908100.0,-1.0
929,ACGL,2023-11-07,81.21624755859375,81.37789856879849,80.75981306855556,80.96901190754056,1647800.0,0.23772430419921875,0.0,0.23772430419921875,53.48727306628678,77.03229164206486,86.19894942102837,45.64319970721078,-54.35680029278922,1.181877676665863,1.1614863844502628,0.02299681891208749,291555900.0,1.0
930,ACGL,2023-11-08,79.98958587646484,81.74874668228223,79.4570777735966,81.11164641692231,1692300.0,-1.2266616821289062,1.2266616821289062,0.0,46.88723493684735,77.03229164206486,86.19894942102837,32.26142292763075,-67.73857707236925,1.0310599625467205,1.1354011000695543,0.02025475825232781,289863600.0,-1.0
931,ACGL,2023-11-09,80.5125732421875,81.03557031252781,79.83743618624439,80.01810922050372,2357600.0,0.5229873657226562,0.0,0.5229873657226562,49.926827679890806,77.03229164206486,86.19894942102837,37.96674517630087,-62.033254823699124,0.9428677545902531,1.096894430973694,0.040683310390449146,292221200.0,1.0
932,ACGL,2023-11-10,81.72972869873047,81.91040174747509,80.51257969720535,80.92146637004085,2069600.0,1.2171554565429688,0.0,1.2171554565429688,56.597025857202915,77.03229164206486,86.19894942102837,51.24481757621319,-48.75518242378682,0.9601213858632178,1.0695398219515988,0.03704150090911318,294290800.0,1.0
933,ACGL,2023-11-13,82.31928253173828,82.7091543975025,81.66316024778376,81.92941792075385,1681100.0,0.5895538330078125,0.0,0.5895538330078125,59.6044358105777,77.03229164206486,86.19894942102837,57.67632017207506,-42.32367982792495,1.0097275692843937,1.0575773714181578,-0.0012690375299105883,295971900.0,1.0
934,ACGL,2023-11-14,81.30182647705078,82.48093865426837,80.67422994826676,82.34781343691058,1872700.0,-1.0174560546875,1.0174560546875,0.0,52.377444274433394,77.03229164206486,86.19894942102837,46.57678881373798,-53.42321118626202,0.9559213602599925,1.0372461691865247,-0.04999993313872242,294099200.0,-1.0
935,ACGL,2023-11-15,78.60127258300781,81.48249384391208,78.55372475664593,81.32083558714955,2829100.0,-2.7005538940429688,2.7005538940429688,0.0,38.194535908150904,77.03229164206486,86.19894942102837,17.116172314664038,-82.88382768533596,0.687443007109124,0.9672855367710446,-0.038166194312083346,291270100.0,-1.0
936,ACGL,2023-11-16,79.59971618652344,80.44601530965096,78.71538025109152,79.00065271598444,1932500.0,0.998443603515625,0.0,0.998443603515625,44.59469725786529,77.8215352013053,86.19894942102837,21.225893080847584,-78.77410691915242,0.5489105334723945,0.8836105361113146,-0.02150793073938173,293202600.0,1.0
937,ACGL,2023-11-17,79.4951171875,80.33191255306937,79.14328936768577,79.87547805777879,1883500.0,-0.1045989990234375,0.1045989990234375,0.0,44.04338626852854,78.55372475664593,86.19894942102837,12.31346980867447,-87.68653019132553,0.4257742247639982,0.7920432738418514,-0.01831851220890257,291319100.0,-1.0
938,ACGL,2023-11-20,80.3128890991211,80.56963576530038,79.40953839611706,79.49511578165678,1762500.0,0.8177719116210938,0.0,0.8177719116210938,49.65772759898983,78.55372475664593,86.19894942102837,23.009975765274127,-76.99002423472588,0.389683147076056,0.7115712484886924,-0.01112287856959815,293081600.0,1.0
939,ACGL,2023-11-21,81.90088653564453,82.57602361113653,80.80735904654533,80.82637382475387,1356300.0,1.5879974365234375,0.0,1.5879974365234375,58.89784509279406,78.55372475664593,85.8566296521574,45.83329273609797,-54.16670726390203,0.48364368630728904,0.6659857360524117,0.023894368726092408,294437900.0,1.0
940,ACGL,2023-11-22,81.72972869873047,82.60456089150942,80.82637796456801,81.83432812118468,1807500.0,-0.1711578369140625,0.1711578369140625,0.0,57.58341647603433,78.55372475664593,82.7091543975025,76.43021821035714,-23.569781789642864,0.5380942678166036,0.6404074424052502,0.015117582354269965,292630400.0,-1.0
941,ACGL,2023-11-24,82.34780883789062,82.87080591600193,81.70119756621658,81.70119756621658,741500.0,0.6180801391601562,0.0,0.6180801391601562,61.19213688726067,78.55372475664593,82.87080591600193,87.88540083436094,-12.114599165639065,0.6239283895837815,0.6371116318409564,0.007562488570572734,293371900.0,1.0
942,ACGL,2023-11-27,82.7281723022461,83.14656997794799,82.00548738642829,82.38584825026818,1842600.0,0.38036346435546875,0.0,0.38036346435546875,63.40301486185005,78.55372475664593,83.14656997794799,90.89022913810967,-9.109770861890322,0.714409434967223,0.6525711924662098,0.0049671201926495545,295214500.0,1.0
943,ACGL,2023-11-28,80.30337524414062,82.88031655760442,80.2463236557973,82.52848150166771,1621100.0,-2.4247970581054688,2.4247970581054688,0.0,44.679789319222884,78.55372475664593,83.14656997794799,38.095132824847745,-61.904867175152255,0.583726620476142,0.6388022780681962,-0.012280797076459127,293593400.0,-1.0
944,ACGL,2023-11-29,78.33501434326172,80.24632232361088,78.06876392903987,79.98007190938905,2218500.0,-1.9683609008789062,1.9683609008789062,0.0,34.99912455818543,78.06876392903987,83.14656997794799,5.243414412787504,-94.7565855872125,0.31766740198165166,0.5745753028508873,-0.003387454566526338,291374900.0,-1.0
945,ACGL,2023-11-30,79.58070373535156,79.65677010740502,78.48716892765161,78.48716892765161,3726900.0,1.2456893920898438,0.0,1.2456893920898438,43.87839158303262,78.06876392903987,83.14656997794799,29.775454039580758,-70.22454596041923,0.20496753954462577,0.500653750189635,-0.00023885074071527956,295101800.0,1.0
946,ACGL,2023-12-01,78.57274627685547,80.3794550119492,78.48716888779614,79.59020745720494,1659900.0,-1.0079574584960938,1.0079574584960938,0.0,38.91523566248659,78.06876392903987,83.14656997794799,9.925198854807885,-90.07480114519211,0.0339272513216855,0.4073084504160451,-0.01160286245592912,293441900.0,-1.0
947,ACGL,2023-12-04,77.96416473388672,79.00064785475728,77.58380388902799,78.5156875961929,1662500.0,-0.60858154296875,0.60858154296875,0.0,36.07267313322896,77.58380388902799,83.14656997794799,6.837620686879801,-93.1623793131202,-0.14901312323590332,0.2960441356856554,-0.02924467531401609,291779400.0,-1.0
948,ACGL,2023-12-05,77.83103942871094,78.4491248939831,77.28902758327096,77.98318666837534,1211300.0,-0.13312530517578125,0.13312530517578125,0.0,35.41965619023958,77.28902758327096,83.14656997794799,9.25322957854338,-90.74677042145663,-0.3012640037353975,0.1765825078014448,-0.049692344968235935,290568100.0,-1.0
949,ACGL,2023-12-06,76.0433578491211,78.42060421301869,75.37772451436167,78.16385754304086,1797000.0,-1.7876815795898438,1.7876815795898438,0.0,27.660930969451456,75.37772451436167,83.14656997794799,8.567982692915415,-91.43201730708459,-0.5597227511739504,0.02932145600636572,-0.06957530558519653,288771100.0,-1.0
950,ACGL,2023-12-07,74.4933853149414,76.48076696062354,74.35075634317701,76.09089509172126,2321600.0,-1.5499725341796875,1.5499725341796875,0.0,22.688830602230126,74.35075634317701,83.14656997794799,1.6215551816669325,-98.37844481833307,-0.879484846609671,-0.1524398045168417,-0.09538108704763948,286449500.0,-1.0
951,ACGL,2023-12-08,75.40625762939453,75.49183501627374,74.47437386184443,74.81669791892159,1372900.0,0.912872314453125,0.0,0.912872314453125,31.104659290304866,74.35075634317701,83.14656997794799,12.000041497525464,-87.99995850247454,-1.047166362432165,-0.33138511609990645,-0.08850569847114553,287822400.0,1.0
952,ACGL,2023-12-11,75.70103454589844,76.77554730135546,75.43478411125636,75.43478411125636,1320000.0,0.29477691650390625,0.0,0.29477691650390625,33.79006048351749,74.35075634317701,83.14656997794799,15.35137349185758,-84.64862650814243,-1.1430922819174896,-0.4937265492634232,-0.057311921002697774,289142400.0,1.0
953,ACGL,2023-12-12,76.338134765625,76.82309505957505,75.63447186689957,75.85317447167493,1372200.0,0.6371002197265625,0.0,0.6371002197265625,39.65572954330932,74.35075634317701,83.14656997794799,22.59459448517221,-77.40540551482779,-1.154398414619635,-0.6258609223346657,-0.025491532673836637,290514600.0,1.0
954,ACGL,2023-12-13,74.53142547607422,76.42371880738418,74.11303504879105,76.21451996635251,2106500.0,-1.8067092895507812,1.8067092895507812,0.0,30.743663236056506,74.11303504879105,83.14656997794799,4.631524985116956,-95.36847501488305,-1.2942259158789824,-0.7595339210435291,-0.06344852485935404,288408100.0,-1.0
955,ACGL,2023-12-14,71.00359344482422,74.17008737787297,70.3760041702664,74.15107259885374,3856100.0,-3.52783203125,3.52783203125,0.0,20.409546735501493,70.3760041702664,83.14656997794799,4.914341964240306,-95.08565803575969,-1.670450861912613,-0.941717309217346,-0.09633305682559334,284552000.0,-1.0
956,ACGL,2023-12-15,69.81497192382812,71.12721660580976,69.27296002402976,70.68029311294822,4562700.0,-1.1886215209960938,1.1886215209960938,0.0,18.050720846078306,69.27296002402976,82.88031655760442,3.9832270026952914,-96.01677299730471,-2.0409963300023293,-1.1615731133743428,-0.1045248523840927,279989300.0,-1.0
957,ACGL,2023-12-18,70.98457336425781,71.5360962267675,69.95760125919419,71.21278696934539,1849600.0,1.1696014404296875,0.0,1.1696014404296875,27.55681814322044,69.27296002402976,80.3794550119492,15.410922546579997,-84.58907745342,-2.2147489740839035,-1.372208285516255,-0.08796575395506723,281838900.0,1.0
958,ACGL,2023-12-19,71.1557388305664,71.42198925853656,70.70881536013934,71.01310259993095,1954000.0,0.17116546630859375,0.0,0.17116546630859375,28.948552055990532,69.27296002402976,80.3794550119492,16.952052007267376,-83.04794799273263,-2.3119864332561377,-1.5601639150642317,-0.06427410830874003,283792900.0,1.0
959,ACGL,2023-12-20,69.99564361572266,70.90850536318905,69.72939317955917,70.7753801451073,1564100.0,-1.16009521484375,1.16009521484375,0.0,25.167412894232598,69.27296002402976,80.3794550119492,6.506855605471962,-93.49314439452804,-2.454365412045206,-1.7390042144604267,-0.060377732602744594,282228800.0,-1.0
960,ACGL,2023-12-21,70.51863861083984,70.58520121788432,69.6057696359726,69.8054647118861,1781600.0,0.5229949951171875,0.0,0.5229949951171875,29.92832453619596,69.27296002402976,79.00064785475728,12.805495082554724,-87.19450491744529,-2.4962255193259324,-1.8904484754335278,-0.06481715406931188,284010400.0,1.0
961,ACGL,2023-12-22,70.21434020996094,70.88948451428487,69.89103820938185,70.57568627505482,1303400.0,-0.30429840087890625,0.30429840087890625,0.0,28.702389493923604,69.27296002402976,78.4491248939831,10.258972013609508,-89.74102798639049,-2.524849401518253,-2.017328660650473,-0.07247845909702666,282707000.0,-1.0
962,ACGL,2023-12-26,69.90055084228516,70.36648907645305,69.59626361214575,70.36648907645305,1158600.0,-0.31378936767578125,0.31378936767578125,0.0,27.368492213502122,69.27296002402976,78.42060421301869,6.8606824368052415,-93.13931756319475,-2.5435339379619535,-2.122569716112769,-0.08432985614731947,281548400.0,-1.0
963,ACGL,2023-12-27,69.9290771484375,70.00515077022418,69.4536278944406,69.65331571054571,950800.0,0.02852630615234375,0.0,0.02852630615234375,27.72084089159941,69.27296002402976,76.82309505957505,8.690137611033547,-91.30986238896645,-2.5269110752779227,-2.2034379879458,-0.061750440143052754,282499200.0,1.0
964,ACGL,2023-12-28,70.42354583740234,70.62323366671225,69.90055597628982,70.10024380559973,1336400.0,0.49446868896484375,0.0,0.49446868896484375,34.1135488706053,69.27296002402976,76.82309505957505,15.239274634900454,-84.76072536509955,-2.4456459618014605,-2.2518795827169322,-0.008169271149249924,283835600.0,1.0
965,ACGL,2023-12-29,70.62322998046875,70.87046562732982,69.96711493406282,70.29992796554119,1332300.0,0.19968414306640625,0.0,0.19968414306640625,36.72139152554121,69.27296002402976,76.82309505957505,17.884050418728332,-82.11594958127168,-2.3381768847100233,-2.2691390431155507,0.011577145050240434,285167900.0,1.0
966,ACGL,2024-01-02,71.84038543701172,72.02105122092443,70.63274026487665,70.94653851478071,1859700.0,1.2171554565429688,0.0,1.2171554565429688,50.50088072968144,69.27296002402976,76.82309505957505,34.0050264120413,-65.99497358795871,-2.130236552737969,-2.2413585450400344,0.012056310719264385,287027600.0,1.0
967,ACGL,2024-01-03,73.1621322631836,73.84678033788117,72.03056073668178,72.1827079776278,2213900.0,1.321746826171875,0.0,1.321746826171875,61.11163036461736,69.27296002402976,76.42371880738418,54.38824545735028,-45.61175454264971,-1.837605644942883,-2.160607965020604,0.0281972117160465,289241500.0,1.0
968,ACGL,2024-01-04,73.66610717773438,74.6074946514535,73.50445617558881,73.90383180022363,1945600.0,0.5039749145507812,0.0,0.5039749145507812,64.46310985319595,69.27296002402976,74.6074946514535,82.35295973373871,-17.647040266261282,-1.5471919132310887,-2.037924754662701,0.05243845720117424,291187100.0,1.0
969,ACGL,2024-01-05,73.03851318359375,74.17008474677283,72.73422594661871,73.83727171489075,2073900.0,-0.627593994140625,0.627593994140625,0.0,57.360069756222664,69.27296002402976,74.6074946514535,70.5882222641515,-29.4117777358485,-1.3520924487361299,-1.9007582934773868,0.03573345462126598,289113200.0,-1.0
970,ACGL,2024-01-08,73.33329772949219,73.50445975621346,72.00203832774676,73.36182352481572,1484600.0,0.2947845458984375,0.0,0.2947845458984375,59.76295448448772,69.4536278944406,74.6074946514535,75.27687497493994,-24.723125025060057,-1.1603127056699805,-1.7526691759159057,0.04442052022713128,290597800.0,1.0
971,ACGL,2024-01-09,72.41092681884766,73.24771494020285,71.17475578852768,73.0480271131106,1839100.0,-0.9223709106445312,0.9223709106445312,0.0,49.659544506587515,69.4536278944406,74.6074946514535,57.380197506717536,-42.619802493282464,-1.070414430263071,-1.6162182267853387,0.03591353639296213,288758700.0,-1.0
972,ACGL,2024-01-10,73.18115234375,73.51396538896095,72.49650421944159,72.49650421944159,1587600.0,0.7702255249023438,0.0,0.7702255249023438,56.710929027971005,69.4536278944406,74.6074946514535,72.32481212746407,-27.675187872535933,-0.9263403614447867,-1.4782426537172284,0.04650533551886249,290346300.0,1.0
973,ACGL,2024-01-11,73.80874633789062,73.90383473971248,73.04802461375579,73.45691127089177,1314900.0,0.627593994140625,0.0,0.627593994140625,61.74843162000403,69.4536278944406,74.6074946514535,84.50196034897473,-15.498039651025264,-0.7528407540181661,-1.333162273777416,0.04806915727169159,291661200.0,1.0
974,ACGL,2024-01-12,73.87530517578125,74.2651697797953,73.27623449078408,73.91334198552549,1212100.0,0.066558837890625,0.0,0.066558837890625,62.28548859502695,69.4536278944406,74.6074946514535,85.79339532447266,-14.20660467552734,-0.60301909441894,-1.187133637905721,0.046048236482696625,292873300.0,1.0
975,ACGL,2024-01-16,74.33173370361328,74.76914614127291,73.74218127905367,74.67405774261296,1468300.0,0.45642852783203125,0.0,0.45642852783203125,66.05638158621464,69.4536278944406,74.76914614127291,91.77102932681494,-8.228970673185056,-0.4423551868783022,-1.038177947700237,0.03467893791836518,294341600.0,1.0
976,ACGL,2024-01-17,74.80718231201172,75.39674198630975,74.11303047842796,74.11303047842796,1439500.0,0.4754486083984375,0.0,0.4754486083984375,69.69793477451788,69.4536278944406,75.39674198630975,90.07995362053347,-9.920046379466523,-0.2735102969741945,-0.8852444175550285,0.022484993232707362,295781100.0,1.0
977,ACGL,2024-01-18,75.08294677734375,75.17803517903202,73.72316159433946,73.86579782426188,1801800.0,0.27576446533203125,0.0,0.27576446533203125,71.7278154849165,69.90055597628982,75.39674198630975,94.29067341618482,-5.709326583815189,-0.11610918318265817,-0.7314173706805545,0.019233262810955498,297582900.0,1.0
978,ACGL,2024-01-19,76.9086685180664,77.37461400923287,75.74857843529686,75.74857843529686,1997000.0,1.8257217407226562,0.0,1.8257217407226562,81.29814898402634,69.96711493406282,77.37461400923287,93.70981371123872,-6.290186288761282,0.15417557968238782,-0.554298780607966,0.052987871272028864,299579900.0,1.0
979,ACGL,2024-01-22,76.51880645751953,77.2985429679166,76.35715544732528,77.03229253823665,1641500.0,-0.389862060546875,0.389862060546875,0.0,75.03948223419593,70.63274026487665,77.37461400923287,87.30608753345824,-12.693912466541754,0.3330800519725443,-0.3768230140918639,0.04343877647201788,297938400.0,-1.0
980,ACGL,2024-01-23,76.39518737792969,77.04179869357462,76.0813963645043,76.48077202143139,1178700.0,-0.12361907958984375,0.12361907958984375,0.0,72.9838271717799,71.17475578852768,77.37461400923287,84.20243501646107,-15.797564983538937,0.4595902384209438,-0.20954036358930236,0.05502291897256839,296759700.0,-1.0
981,ACGL,2024-01-24,76.19549560546875,76.99425413275826,76.10991822117698,76.97523209972901,1486600.0,-0.1996917724609375,0.1996917724609375,0.0,69.43829030677928,71.17475578852768,77.37461400923287,80.98152632222606,-19.018473677773944,0.5375405822691448,-0.060124174417612884,0.04119015846538776,295273100.0,-1.0
982,ACGL,2024-01-25,75.69152069091797,76.528316031023,74.80718477771242,76.07188154962208,1620800.0,-0.5039749145507812,0.5039749145507812,0.0,60.8325532607544,71.17475578852768,77.37461400923287,72.85271278149548,-27.147287218504513,0.5522838432998043,0.06235742912587059,0.025508824447554534,293652300.0,-1.0
983,ACGL,2024-01-26,75.97679138183594,76.1954939735285,75.35870590766255,75.87219196675522,1321900.0,0.28527069091796875,0.0,0.28527069091796875,63.765520553511024,71.17475578852768,77.37461400923287,77.4539581771607,-22.546041822839307,0.5802976346272573,0.16594547022614795,0.028446396276189168,294974200.0,1.0
984,ACGL,2024-01-29,75.81513977050781,75.91022816851512,75.12098068097296,75.37772008107066,1323500.0,-0.161651611328125,0.161651611328125,0.0,60.78920343850236,71.17475578852768,77.37461400923287,74.84661449971547,-25.153385500284532,0.5827373980442019,0.2493038557897588,0.01995656488801134,293650700.0,-1.0
985,ACGL,2024-01-30,76.62340545654297,76.6899680635977,75.6059443174034,75.71054373631513,1036900.0,0.8082656860351562,0.0,0.8082656860351562,69.1080124551259,72.49650421944159,77.37461400923287,84.60041727100929,-15.399582728990701,0.6424850463532437,0.3279400939024558,0.024278726833421027,294687600.0,1.0
986,ACGL,2024-01-31,78.382568359375,78.7153814034355,77.0037683533614,77.01327211549152,2325800.0,1.7591629028320312,0.0,1.7591629028320312,79.84589789714602,73.04802461375579,78.7153814034355,94.12754381960643,-5.872456180393566,0.8223061984297999,0.4268133148079247,0.043946351650477666,297013400.0,1.0
987,ACGL,2024-02-01,78.05925750732422,78.28747837990109,77.07983317388381,77.5743044763536,1841500.0,-0.32331085205078125,0.32331085205078125,0.0,74.36438974384357,73.27623449078408,78.7153814034355,87.93700727985225,-12.062992720147744,0.9280295265491958,0.5270565571561789,0.014960459092950407,295171900.0,-1.0
988,ACGL,2024-02-02,79.20984649658203,79.53314849834766,78.54421320594389,79.07672128941034,1514700.0,1.1505889892578125,0.0,1.1505889892578125,80.00186642551292,73.72316159433946,79.53314849834766,94.43540911352854,-5.564590886471466,1.09207023545477,0.6400592928158972,0.035168348326975796,296686600.0,1.0
989,ACGL,2024-02-05,79.55217742919922,79.78990207044625,78.80096669228497,78.94359567320895,1803900.0,0.3423309326171875,0.0,0.3423309326171875,81.40563731554516,73.72316159433946,79.78990207044625,96.08150963135344,-3.918490368646563,1.2354553640032009,0.7591385070533581,0.04132446243834442,298490500.0,1.0
990,ACGL,2024-02-06,79.20984649658203,80.01810875577578,79.08622505079425,79.85645775489297,1307200.0,-0.3423309326171875,0.3423309326171875,0.0,75.30625670937857,73.72316159433946,80.01810875577578,87.16014227815486,-12.83985772184514,1.306406426058814,0.8685920908544493,0.039560749190755695,297183300.0,-1.0
991,ACGL,2024-02-07,80.27484893798828,80.56012138744508,78.95310061474595,79.28591363592572,1385300.0,1.06500244140625,0.0,1.06500244140625,80.54013333324642,74.80718477771242,80.56012138744508,95.04127250465125,-4.958727495348758,1.432064502185412,0.9812865731206418,0.06055273041462694,298568600.0,1.0
992,ACGL,2024-02-08,78.69636535644531,80.10369113573506,76.99425609592556,79.8469517215336,1897700.0,-1.5784835815429688,1.5784835815429688,0.0,59.11325881551589,74.80718477771242,80.56012138744508,67.60339705730955,-32.39660294269046,1.3882758202562684,1.0626844225477672,0.03579479897935722,296670900.0,-1.0
993,ACGL,2024-02-09,79.36199188232422,79.41904347362913,77.583808987259,78.30649391450211,1130900.0,0.6656265258789062,0.0,0.6656265258789062,63.79925994967498,74.80718477771242,80.56012138744508,79.17360147695877,-20.82639852304123,1.3912460536268298,1.1283967487635798,0.04678290012460207,297801800.0,1.0
994,ACGL,2024-02-12,79.01966857910156,79.5046288741624,78.68685553534618,79.4761030782377,1375200.0,-0.34232330322265625,0.34232330322265625,0.0,59.73656785366321,74.80718477771242,80.56012138744508,73.22319168722593,-26.776808312774065,1.350410661809633,1.1727995313727904,0.03127325271281034,296426600.0,-1.0
995,ACGL,2024-02-13,79.93252563476562,80.30337546959802,79.0386859774982,79.23837379204028,1586100.0,0.9128570556640625,0.0,0.9128570556640625,66.33309915108487,74.80718477771242,80.56012138744508,89.0908627149184,-10.909137285081592,1.3758483317857753,1.2134092914553873,0.019774259862017418,298012700.0,1.0
996,ACGL,2024-02-14,80.7027587890625,81.17820804190414,79.78989709418012,79.87547447739728,2336100.0,0.770233154296875,0.0,0.770233154296875,70.96439986103822,75.12098068097296,81.17820804190414,92.15071146398984,-7.849288536010164,1.4415420475595937,1.2590358426762287,0.03386531420043615,300348800.0,1.0
997,ACGL,2024-02-15,83.10853576660156,84.09747114161766,80.63620095645146,82.18616300073172,2431200.0,2.4057769775390625,0.0,2.4057769775390625,80.5882017199293,75.12098068097296,84.09747114161766,88.98305101139637,-11.016948988603636,1.668497486359172,1.3409281714128174,0.04921975540235102,302780000.0,1.0
998,ACGL,2024-02-16,81.88187408447266,84.41126043532782,81.79628944315213,84.07844739637058,2370300.0,-1.2266616821289062,1.2266616821289062,0.0,67.43786128196271,75.6059443174034,84.41126043532782,71.27432658884044,-28.725673411159562,1.7294440066578574,1.4186313384618254,0.029285140024568834,300409700.0,-1.0
999,ACGL,2024-02-20,81.17820739746094,81.86284822210273,80.9499865344672,81.8057966337442,1871900.0,-0.7036666870117188,0.7036666870117188,0.0,60.86406031148591,76.99425609592556,84.41126043532782,56.41025824008838,-43.58974175991162,1.701352410701105,1.4751755529096815,0.024849952221077,298537800.0,-1.0
1000,ACGL,2024-02-21,80.55061340332031,82.01499800641425,79.84695052422688,81.99598322796524,1825400.0,-0.627593994140625,0.627593994140625,0.0,55.3150472775676,76.99425609592556,84.41126043532782,47.9487019914749,-52.0512980085251,1.6098902159237554,1.5021184855124965,0.003435253619038958,296712400.0,-1.0
1001,ACGL,2024-02-22,81.60610961914062,81.72022005175535,79.87547462577339,80.82637313322309,1721700.0,1.0554962158203125,0.0,1.0554962158203125,62.0323424937001,76.99425609592556,84.41126043532782,62.17946373194027,-37.820536268059726,1.6040846022927013,1.5225117088685376,0.03697431577069654,298434100.0,1.0
1002,ACGL,2024-02-23,83.00393676757812,83.05147734305052,81.57758891736039,81.69169935709873,1696500.0,1.3978271484375,0.0,1.3978271484375,69.12467870946716,76.99425609592556,84.41126043532782,81.02571330215628,-18.974286697843723,1.6927634569893968,1.5565620584927096,0.0458902907912655,300130600.0,1.0
1003,ACGL,2024-02-26,82.99442291259766,83.80268521579332,82.57602523597775,82.86129769817862,1548600.0,-0.00951385498046875,0.00951385498046875,0.0,69.02342219750861,76.99425609592556,84.41126043532782,80.89744244582245,-19.102557554177555,1.7421915005055837,1.5936879468952847,0.05030082263021929,298582000.0,-1.0
1004,ACGL,2024-02-27,82.93737030029297,83.02294768503087,81.92942018788654,82.85178566077506,1817000.0,-0.0570526123046875,0.0570526123046875,0.0,68.33083654755083,76.99425609592556,84.41126043532782,80.12822876204987,-19.871771237950124,1.756511935891325,1.6262527446944928,0.03759226474661048,296765000.0,-1.0
1005,ACGL,2024-02-28,83.94532012939453,84.1259931696048,82.82325958634438,83.08951001100375,1247600.0,1.0079498291015625,0.0,1.0079498291015625,73.70860314658853,76.99425609592556,84.41126043532782,93.7179448115189,-6.282055188481096,1.828120674359596,1.6666263306275135,0.04017906437135932,298012600.0,1.0
1006,ACGL,2024-02-29,83.28919982910156,83.80268591246379,82.16714651389317,83.76464910020212,3310000.0,-0.6561203002929688,0.6561203002929688,0.0,65.37097049472116,77.583808987259,84.41126043532782,83.56545462445378,-16.43454537554621,1.8110510218613882,1.6955112688742886,0.0021738328179354838,294702600.0,-1.0
1007,ACGL,2024-03-01,82.88982391357422,83.38429521659128,82.53799609716066,82.91834970898287,1225900.0,-0.39937591552734375,0.39937591552734375,0.0,60.559753167147996,78.68685553534618,84.41126043532782,73.42192684940088,-26.578073150599124,1.7451795570203075,1.7054449265034926,0.012309804097323518,293476700.0,-1.0
1008,ACGL,2024-03-04,82.86129760742188,83.26067325024158,82.30977471698701,82.8898234026547,1051700.0,-0.02852630615234375,0.02852630615234375,0.0,60.19463001982662,79.0386859774982,84.41126043532782,71.15046352410927,-28.849536475890737,1.6714071706053915,1.6986373753238722,0.020733276379463206,292425000.0,-1.0
1009,ACGL,2024-03-05,83.0990219116211,84.04040942447634,82.78522365574267,83.10853292825439,1202000.0,0.23772430419921875,0.0,0.23772430419921875,62.375842654796536,79.78989709418012,84.41126043532782,71.60494800262047,-28.39505199737953,1.6135246793548106,1.6816148361300598,0.031637356944022255,293627000.0,1.0
1010,ACGL,2024-03-06,84.45880889892578,84.52537150721733,82.57602657831032,83.09902368258689,1337600.0,1.3597869873046875,0.0,1.3597869873046875,72.36892260056901,79.84695052422688,84.52537150721733,98.57724201106414,-1.4227579889358573,1.6582604395633638,1.6769439568167206,0.03495693267451205,294964600.0,1.0
1011,ACGL,2024-03-07,83.38429260253906,84.53487892822527,82.97540595334645,84.24960647352164,2051300.0,-1.0745162963867188,1.0745162963867188,0.0,58.260019835010944,79.84695052422688,84.53487892822527,75.45640149485095,-24.54359850514906,1.5886958697635833,1.659294339406093,0.00458238307450376,292913300.0,-1.0
1012,ACGL,2024-03-08,83.30821990966797,83.7266175799578,82.73768224867815,83.25116832000298,1208600.0,-0.07607269287109375,0.07607269287109375,0.0,57.346719943151655,79.84695052422688,84.53487892822527,73.83366568672275,-26.16633431327724,1.510020440776728,1.6294395596802203,0.0037809407675595263,291704700.0,-1.0
1013,ACGL,2024-03-11,85.87564086914062,86.04680288864552,83.30821783134698,83.30821783134698,2107900.0,2.5674209594726562,0.0,2.5674209594726562,73.51488745104655,79.84695052422688,86.04680288864552,97.23925652670053,-2.7607434732994798,1.6359804468472134,1.6307477371136192,0.03542758298471482,293812600.0,1.0
1014,ACGL,2024-03-12,86.45569610595703,86.50324393629366,85.32413174270464,85.87564739879575,1886400.0,0.5800552368164062,0.0,0.5800552368164062,75.89668736919515,79.87547462577339,86.50324393629366,99.28259678167807,-0.7174032183219351,1.7622956220975112,1.6570573141103977,0.029904894908888036,295699000.0,1.0
1015,ACGL,2024-03-13,86.53176879882812,87.07378068682738,86.06583053663445,86.7124418464213,1592200.0,0.07607269287109375,0.0,0.07607269287109375,76.22029390218412,81.57758891736039,87.07378068682738,90.13841018047638,-9.861589819523616,1.847245838923243,1.695095019072967,0.038931445810259646,297291200.0,1.0
1016,ACGL,2024-03-14,86.56029510498047,87.05476642085075,86.0182832137867,86.72194611968486,1424600.0,0.02852630615234375,0.0,0.02852630615234375,76.3576336184,81.92942018788654,87.07378068682738,90.01847592227202,-9.981524077727988,1.895026644745613,1.7350813442074964,0.044281324511357356,298715800.0,1.0
1017,ACGL,2024-03-15,87.3685531616211,87.49217461193466,86.04680480289873,86.04680480289873,3505500.0,0.808258056640625,0.0,0.808258056640625,80.11270203262302,81.92942018788654,87.49217461193466,97.77769355089376,-2.2223064491062416,1.9753424299538835,1.7831335613567738,0.05439518429404244,302221300.0,1.0
1018,ACGL,2024-03-18,86.91212463378906,87.24493765891616,86.29403915582171,86.89310260105046,1446900.0,-0.45642852783203125,0.45642852783203125,0.0,72.59940407827814,82.16714651389317,87.49217461193466,89.10710014170753,-10.892899858292475,1.9793466249201686,1.8223761740694526,0.04588625274342384,300774400.0,-1.0
1019,ACGL,2024-03-19,87.16886901855469,87.34954206599626,86.636368147923,87.26395742334174,1581000.0,0.256744384765625,0.0,0.256744384765625,74.17158686266528,82.16714651389317,87.49217461193466,93.92856549435147,-6.071434505648531,1.9804081915568617,1.8539825775669345,0.03208735897367565,302355400.0,1.0
1020,ACGL,2024-03-20,87.70137786865234,88.03419091554723,86.81704191274292,87.09279611246988,1681600.0,0.5325088500976562,0.0,0.5325088500976562,77.29000185501766,82.30977471698701,88.03419091554723,94.18607880086371,-5.813921199136287,2.001150487458858,1.8834161595453196,0.05177336320032322,304037000.0,1.0
1021,ACGL,2024-03-21,86.23699188232422,87.43511883273406,86.06582985301135,87.36855622437797,2040300.0,-1.464385986328125,1.464385986328125,0.0,55.88169230173613,82.30977471698701,88.03419091554723,68.60467564054773,-31.39532435945228,1.877779324513071,1.8822887925388698,0.03515585827943446,301996700.0,-1.0
1022,ACGL,2024-03-22,86.22747802734375,86.37961801795856,85.53331891609498,86.37011425620636,1888900.0,-0.00951385498046875,0.00951385498046875,0.0,55.76590080978133,82.57602657831032,88.03419091554723,66.89889170471382,-33.101108295286174,1.7589628713860037,1.8576236083082966,0.00409705423612805,300107800.0,-1.0
1023,ACGL,2024-03-25,86.52225494384766,86.84556421552618,85.59037845002725,86.39864074705352,2071200.0,0.29477691650390625,0.0,0.29477691650390625,58.81669654918209,82.57602657831032,88.03419091554723,72.299552041979,-27.700447958021,1.6693428644532986,1.8199674595372972,0.0007698606441044475,302179000.0,1.0
1024,ACGL,2024-03-26,86.14189147949219,87.0642641836164,85.79006367817703,86.47471175772408,1945900.0,-0.38036346435546875,0.38036346435546875,0.0,53.33950242895351,82.73768224867815,88.03419091554723,64.27270198023416,-35.72729801976584,1.5497615243784821,1.765926272505534,-0.004505597478798085,300233100.0,-1.0
1025,ACGL,2024-03-27,86.98819732666016,87.23542571138428,86.37011185529032,86.5602886519673,3025500.0,0.8463058471679688,0.0,0.8463058471679688,62.34247173123259,82.73768224867815,88.03419091554723,80.25126258302923,-19.74873741697076,1.5059229178332316,1.7139256015710735,0.00494340067996224,303258600.0,1.0
1026,ACGL,2024-03-28,87.90106201171875,88.02467620830306,86.69341682175354,87.4065907158215,2463000.0,0.9128646850585938,0.0,0.9128646850585938,69.6344386454977,83.30821783134698,88.03419091554723,97.18303719770324,-2.8169628022967608,1.5272360309681545,1.6765876874504897,0.006094971598219923,305721600.0,1.0
1027,ACGL,2024-04-01,87.7774429321289,88.54767569178465,87.38757829865644,88.05320438252662,1361200.0,-0.12361907958984375,0.12361907958984375,0.0,67.58941391008348,85.32413174270464,88.54767569178465,76.10602579575306,-23.893974204246945,1.5166685886881481,1.6446038676980215,0.00995624375754156,304360400.0,-1.0
1028,ACGL,2024-04-02,86.9977035522461,88.36699974239916,86.75997892227674,88.02467569486089,1674900.0,-0.7797393798828125,0.7797393798828125,0.0,55.68688418891528,85.53331891609498,88.54767569178465,48.58033554492132,-51.41966445507868,1.4289038490343842,1.6014638639652943,-0.001963607744780549,302685500.0,-1.0
1029,ACGL,2024-04-03,87.70137786865234,87.9200804759917,86.9977077068971,86.9977077068971,1451400.0,0.70367431640625,0.0,0.70367431640625,62.553489512058114,85.53331891609498,88.54767569178465,71.9244307788126,-28.075569221187386,1.3999920600271452,1.5611695031776647,0.0,304136900.0,1.0
1030,ACGL,2024-04-04,86.61734008789062,88.09123565127784,86.3701117036007,87.66333423211626,1466400.0,-1.0840377807617188,1.0840377807617188,0.0,49.044551943832765,85.53331891609498,88.54767569178465,35.961939891724484,-64.03806010827552,1.274910099689734,1.5039176224800788,0.004410499453475936,302670500.0,-1.0
1031,ACGL,2024-04-05,90.24027252197266,90.3448719413204,87.14985227981455,87.48266531647556,2591400.0,3.6229324340820312,0.0,3.6229324340820312,72.19781787584103,85.53331891609498,90.3448719413204,97.82607780067333,-2.173922199326677,1.4513913779311736,1.493412373570298,0.046537305583220334,305261900.0,1.0
1032,ACGL,2024-04-08,89.90745544433594,90.30683107037883,89.11820795374182,90.17370586169787,1371900.0,-0.33281707763671875,0.33281707763671875,0.0,68.88032427977538,85.53331891609498,90.3448719413204,90.9090371717565,-9.090962828243496,1.5465706025204753,1.5040440193603337,0.03912519966897832,303890000.0,-1.0
1033,ACGL,2024-04-09,86.740966796875,90.11665229281407,86.24649548873901,89.8218760641662,2371000.0,-3.1664886474609375,3.1664886474609375,0.0,45.784808594188036,85.53331891609498,90.3448719413204,25.09892075279452,-74.90107924720549,1.3509190988824997,1.4734190352647671,0.0069545177972489824,301519000.0,-1.0
1034,ACGL,2024-04-10,87.66333770751953,88.09123914364521,86.68391338344249,86.85506815406873,1267400.0,0.9223709106445312,0.0,0.9223709106445312,51.27582276303573,85.53331891609498,90.3448719413204,44.26884168703005,-55.73115831296995,1.2558152401989418,1.4298982762516022,0.007761287181571097,302786400.0,1.0
1035,ACGL,2024-04-11,86.82654571533203,87.50168282642711,86.44619209286404,86.99770774735475,1369400.0,-0.8367919921875,0.8367919921875,0.0,46.36062828349819,85.53331891609498,90.3448719413204,26.877533978261813,-73.12246602173819,1.1002397476632524,1.3639665705339323,-0.01222415602036142,301417000.0,-1.0
1036,ACGL,2024-04-12,85.56185150146484,87.21641288486629,84.84867761580114,86.82654101174244,1455000.0,-1.2646942138671875,1.2646942138671875,0.0,39.720732797658904,84.84867761580114,90.3448719413204,12.975776390444999,-87.024223609555,0.8649244843406336,1.2641581532952726,-0.02524101131969858,299962000.0,-1.0
1037,ACGL,2024-04-15,85.35265350341797,87.34002793530189,85.34314248684427,86.66489085416899,1762600.0,-0.209197998046875,0.209197998046875,0.0,38.66382607964161,84.84867761580114,90.3448719413204,9.169542737541716,-90.83045726245828,0.6540158253765185,1.142129687711522,-0.018909120375116495,298199400.0,-1.0
1038,ACGL,2024-04-16,86.39864349365234,86.71244175869768,85.20050928015759,85.81859479333713,1688700.0,1.045989990234375,0.0,1.045989990234375,46.82650190824491,84.84867761580114,90.3448719413204,28.200711002058128,-71.79928899794187,0.5647616236953894,1.0266560749082954,-0.01485420647496627,299888100.0,1.0
1039,ACGL,2024-04-17,86.179931640625,86.47471511981199,85.52381658453288,86.179931640625,1016000.0,-0.21871185302734375,0.21871185302734375,0.0,45.36978459023707,84.84867761580114,90.3448719413204,24.221378393459354,-75.77862160654064,0.47094998881831884,0.9155148576903,-0.005049894707246705,298872100.0,-1.0
1040,ACGL,2024-04-18,86.90261840820312,87.40659348186165,86.42716913044525,86.83605579950823,1407900.0,0.722686767578125,0.0,0.722686767578125,51.162267352509524,84.84867761580114,90.3448719413204,37.37023603523946,-62.62976396476054,0.44973411971778887,0.8223587100957978,-0.03698630357035815,300280000.0,1.0
1041,ACGL,2024-04-19,88.36699676513672,88.40503357522387,86.44618501180355,87.37806146720983,1527600.0,1.4643783569335938,0.0,1.4643783569335938,60.86418036374809,84.84867761580114,90.3448719413204,64.01373279324832,-35.98626720675168,0.5448033320044772,0.7668476344775337,-0.01713382579437983,301807600.0,1.0
1042,ACGL,2024-04-22,89.24182891845703,89.95500284255996,88.43356658876311,89.06116312426823,1275800.0,0.8748321533203125,0.0,0.8748321533203125,65.57785073245316,84.84867761580114,90.3448719413204,79.9307856030152,-20.0692143969848,0.6828663529269505,0.7500513781674172,0.028831383992276693,303083400.0,1.0
1043,ACGL,2024-04-23,89.17526245117188,89.73629635301387,88.86146419699483,89.47003867218547,1459400.0,-0.06656646728515625,0.06656646728515625,0.0,64.89164828934736,84.84867761580114,90.3448719413204,78.7196481624032,-21.280351837596804,0.7779432881349067,0.7556297601609152,0.017246944768367634,301624000.0,-1.0
1044,ACGL,2024-04-24,88.6142349243164,89.07066214878782,88.15780044506508,88.69030129187502,1257600.0,-0.5610275268554688,0.5610275268554688,0.0,58.89823872047791,84.84867761580114,90.3448719413204,68.51208464430536,-31.487915355694646,0.7988139812337494,0.7642666043754821,0.02058920108195328,300366400.0,-1.0
1045,ACGL,2024-04-25,88.48110961914062,88.87097423734892,87.85351311768054,88.47159860266336,1181600.0,-0.13312530517578125,0.13312530517578125,0.0,57.445571756064396,84.84867761580114,90.30683107037883,66.55056574660804,-33.44943425339196,0.7954426881634475,0.7705018211330753,0.03411868801864104,299184800.0,-1.0
1046,ACGL,2024-04-26,86.43667602539062,87.89154958518563,86.3225655924495,87.5872623521225,1458000.0,-2.04443359375,2.04443359375,0.0,39.97484868509767,84.84867761580114,90.11665229281407,30.144381986473828,-69.85561801352618,0.6206477680153455,0.7405310105095294,0.012700513428434368,297726800.0,-1.0
1047,ACGL,2024-04-29,86.76949310302734,87.14034295892088,86.16091860849538,86.34159165539026,2812200.0,0.33281707763671875,0.0,0.33281707763671875,43.21855315316791,84.84867761580114,89.95500284255996,37.61639539057365,-62.38360460942635,0.5031767824342523,0.6930601648944741,0.004292308239796094,300539000.0,1.0
1048,ACGL,2024-04-30,88.94705200195312,89.42250128103898,86.10386734435826,87.95811663088095,3310900.0,2.1775588989257812,0.0,2.1775588989257812,59.67119337886054,84.84867761580114,89.95500284255996,80.26073945848879,-19.73926054151122,0.579115303817133,0.6702711926790059,0.032108639548092954,303849900.0,1.0
1049,ACGL,2024-05-01,91.09608459472656,91.83778430786982,89.03262921393902,89.03262921393902,2578300.0,2.1490325927734375,0.0,2.1490325927734375,69.67648387474233,84.84867761580114,91.83778430786982,89.38777520759625,-10.612224792403742,0.8034444911751848,0.6969058523782418,0.048254773714937915,306428200.0,1.0
1050,ACGL,2024-05-02,90.49700927734375,91.70465444534236,89.85990901804551,91.02951737514545,1458000.0,-0.5990753173828125,0.5990753173828125,0.0,64.52723680146151,85.20050928015759,91.83778430786982,79.79931485544876,-20.20068514455124,0.9222554304117807,0.7419757679849497,0.024104163207766538,304970200.0,-1.0
1051,ACGL,2024-05-03,89.77433013916016,90.89638339547088,88.22436095367243,90.16419474851257,1696500.0,-0.7226791381835938,0.7226791381835938,0.0,58.50871217904547,85.20050928015759,91.83778430786982,68.91112451880859,-31.088875481191398,0.9471812728598508,0.7830168689599301,0.005966946522237837,303273700.0,-1.0
1052,ACGL,2024-05-06,92.37028503417969,92.39881083005925,90.10714908544496,90.10714908544496,1227600.0,2.5959548950195312,0.0,2.5959548950195312,70.07666481836483,85.52381658453288,92.39881083005925,99.58507898536611,-0.41492101463389247,1.163000699191258,0.8590136350061957,0.03582857504632808,304501300.0,1.0
1053,ACGL,2024-05-07,93.38774108886719,93.7015393359365,92.27519158174486,92.85524024883185,1316200.0,1.0174560546875,0.0,1.0174560546875,73.4271256557127,86.10386734435826,93.7015393359365,95.86981054963745,-4.13018945036255,1.4000010096631286,0.9672111099375822,0.05386838997851462,305817500.0,1.0
1054,ACGL,2024-05-08,94.07239532470703,94.80458402764643,93.38774719714898,93.38774719714898,1321400.0,0.6846542358398438,0.0,0.6846542358398438,75.5524870116167,86.10386734435826,94.80458402764643,91.58473112512971,-8.4152688748703,1.6243468784512203,1.09863826364031,0.06319185789637616,307138900.0,1.0
1055,ACGL,2024-05-09,94.7380142211914,94.74752523745727,93.70153834638568,93.91073717555595,859700.0,0.665618896484375,0.0,0.665618896484375,77.56535672132591,86.10386734435826,94.80458402764643,99.23489283839244,-0.7651071616075578,1.8347031619397853,1.2458512433002051,0.09603953527044795,307998600.0,1.0
1056,ACGL,2024-05-10,95.13739776611328,95.90762322909151,94.85212531438366,95.28953775353055,1420400.0,0.399383544921875,0.0,0.399383544921875,78.77522082330644,86.10386734435826,95.90762322909151,92.14356750582036,-7.856432494179641,2.0104635738184413,1.3987737094038526,0.09643832600416546,309419000.0,1.0
1057,ACGL,2024-05-13,93.10247802734375,95.40365071576471,93.0359081660319,95.19445187958463,1171200.0,-2.0349197387695312,2.0349197387695312,0.0,59.81204414266532,86.10386734435826,95.90762322909151,71.3870353900179,-28.61296460998211,1.9629265546897017,1.5116042784610226,0.046717973579375904,308247800.0,-1.0
1058,ACGL,2024-05-14,93.09296417236328,93.48282878308287,92.51291550965139,93.02640156786092,1137700.0,-0.00951385498046875,0.00951385498046875,0.0,59.734472382926576,86.10386734435826,95.90762322909151,71.28999242921464,-28.71000757078537,1.9025539779985081,1.5897942183685199,0.02192058623068771,307110100.0,-1.0
1059,ACGL,2024-05-15,93.06443786621094,93.55890188911077,92.54144079458443,92.59849238247833,1474400.0,-0.02852630615234375,0.02852630615234375,0.0,59.467643617374755,86.10386734435826,95.90762322909151,70.99901918908361,-29.00098081091638,1.831296396590119,1.6380946540128398,0.028370314216670467,305635700.0,-1.0
1060,ACGL,2024-05-16,93.96778869628906,94.49078576884015,93.61595364250199,93.66350146901746,1179500.0,0.903350830078125,0.0,0.903350830078125,65.15496010909956,86.10386734435826,95.90762322909151,80.21335337589109,-19.786646624108915,1.8266605070417654,1.675807824618625,0.04671110940765111,306815200.0,1.0
1061,ACGL,2024-05-17,96.03124237060547,96.3070038202123,94.39569570660919,94.39569570660919,1484800.0,2.0634536743164062,0.0,2.0634536743164062,74.56234319959373,86.10386734435826,96.3070038202123,97.29728745411346,-2.702712545886539,1.9668177470044128,1.7340098090957827,0.03963349615161538,308300000.0,1.0
1062,ACGL,2024-05-20,95.25150299072266,96.28798614982836,95.2229771958924,96.06927629816313,1399100.0,-0.7797393798828125,0.7797393798828125,0.0,66.70964113990698,88.22436095367243,96.3070038202123,86.94114231052869,-13.058857689471298,1.9920122409217669,1.7856102954609794,0.019957243639525668,306900900.0,-1.0
1063,ACGL,2024-05-21,96.6588363647461,97.3815212739446,95.62235320164534,95.80302624263996,1681100.0,1.4073333740234375,0.0,1.4073333740234375,72.69779240240553,88.22436095367243,97.3815212739446,92.10798016063318,-7.892019839366821,2.1013164327628857,1.8487515229213607,0.027494155231314377,308582000.0,1.0
1064,ACGL,2024-05-22,97.65727233886719,98.22781723854754,96.93459470755698,97.0011573118824,1994700.0,0.9984359741210938,0.0,0.9984359741210938,76.2019722836848,88.22436095367243,98.22781723854754,94.29652228757173,-5.703477712428267,2.242654308263326,1.927532079989754,0.030814010000885128,310576700.0,1.0
1065,ACGL,2024-05-23,96.92508697509766,98.69375881255772,96.13583945794268,97.89500027881122,1685100.0,-0.7321853637695312,0.7321853637695312,0.0,68.73700417458089,90.10714908544496,98.69375881255772,79.4019771054067,-20.598022894593303,2.269423847704971,1.9959104335327975,0.01879060444116054,308891600.0,-1.0
1066,ACGL,2024-05-24,98.28487396240234,98.313399757921,97.17232440849382,97.38152324867083,1296900.0,1.3597869873046875,0.0,1.3597869873046875,74.1611635540365,92.27519158174486,98.69375881255772,93.62965541293251,-6.370344587067486,2.373007789585799,2.071329904743398,0.05566335123256927,310188500.0,1.0
1067,ACGL,2024-05-28,97.22937774658203,98.01862529242038,97.04870469867728,97.59071658761127,1722500.0,-1.0554962158203125,1.0554962158203125,0.0,64.1868777829387,92.51291550965139,98.69375881255772,76.3077464641902,-23.692253535809794,2.3429213474659036,2.125648193287899,0.04443314928247544,308466000.0,-1.0
1068,ACGL,2024-05-29,96.56375122070312,97.69531556858857,96.326026581809,97.32446571229616,1368000.0,-0.6656265258789062,0.6656265258789062,0.0,58.46518606083563,92.51291550965139,98.69375881255772,65.53856023411836,-34.46143976588164,2.2395509779575207,2.1484287502218233,0.03760097234480475,307098000.0,-1.0
1069,ACGL,2024-05-30,96.43062591552734,97.97107693109966,96.05976880479227,96.34504127311764,2421900.0,-0.13312530517578125,0.13312530517578125,0.0,57.28673865489445,92.51291550965139,98.69375881255772,63.38472298810398,-36.61527701189601,2.122421165787827,2.143227233335024,0.026209377206888984,304676100.0,-1.0
1070,ACGL,2024-05-31,97.59071350097656,98.39898305512499,96.37356454360581,96.45914918377284,10178700.0,1.1600875854492188,0.0,1.1600875854492188,64.48465749645436,92.51291550965139,98.69375881255772,82.15380559700507,-17.84619440299493,2.0990082580464104,2.1343834382773017,0.016239206032061526,314854800.0,1.0
1071,ACGL,2024-06-03,96.70637512207031,98.01861970291797,95.53677402280506,97.46709682849736,1747000.0,-0.88433837890625,0.88433837890625,0.0,56.16032488658673,92.51291550965139,98.69375881255772,67.84607547722642,-32.15392452277358,1.9861989780736309,2.1047465462365675,0.015274007083010188,313107800.0,-1.0
1072,ACGL,2024-06-04,95.90762329101562,97.27691945255421,95.12788681120166,96.92508439583115,1217600.0,-0.7987518310546875,0.7987518310546875,0.0,49.500755409057724,92.54144079458443,98.69375881255772,54.7140522742368,-45.2859477257632,1.8114627980897353,2.046089796607201,-0.007771799268260771,311890200.0,-1.0
1073,ACGL,2024-06-05,94.78556823730469,96.15486447781353,94.10092011705026,95.63186737073579,1480100.0,-1.1220550537109375,1.1220550537109375,0.0,41.52030683933058,93.61595364250199,98.69375881255772,23.033861198535497,-76.9661388014645,1.5644091166315235,1.9497536606120653,-0.02940594215654302,310410100.0,-1.0
1074,ACGL,2024-06-06,95.16592407226562,96.04074895526543,94.72851163076572,95.45118927074998,1132800.0,0.3803558349609375,0.0,0.3803558349609375,44.98917247696204,94.10092011705026,98.69375881255772,23.18835965776695,-76.81164034223305,1.383362291877603,1.836475386865173,-0.01814971704161583,311542900.0,1.0
1075,ACGL,2024-06-07,95.63186645507812,96.57325398402422,95.47972646024509,95.73646587549214,803500.0,0.4659423828125,0.0,0.4659423828125,49.244703873563616,94.10092011705026,98.69375881255772,33.33333564545552,-66.66666435454448,1.2629208694955736,1.7217644833912533,-0.026993039725920487,312346400.0,1.0
1076,ACGL,2024-06-10,95.64137268066406,95.95517092618626,94.77605156509317,95.50824747131159,955700.0,0.0095062255859375,0.0,0.0095062255859375,49.33696539815953,94.10092011705026,98.69375881255772,33.54031494989388,-66.45968505010612,1.1549240024965997,1.6083963872123226,-0.016332564320805765,313302100.0,1.0
1077,ACGL,2024-06-11,94.69047546386719,95.41315310876536,94.23404098649685,95.36561253608464,1530100.0,-0.950897216796875,0.950897216796875,0.0,40.78097590900837,94.10092011705026,98.69375881255772,12.836404365640014,-87.16359563435998,0.9812944967843009,1.4829760091267183,-0.019399368118523497,311772000.0,-1.0
1078,ACGL,2024-06-12,94.29109954833984,94.8426151694218,92.81720395882836,94.75703778598456,1290300.0,-0.39937591552734375,0.39937591552734375,0.0,37.61938481366823,92.81720395882836,98.69375881255772,25.080946680453884,-74.91905331954611,0.8022180931011604,1.346824425921607,-0.022187208128895852,310481700.0,-1.0
1079,ACGL,2024-06-13,94.2815933227539,94.5288289787688,92.86475650498518,94.35766694841699,1105400.0,-0.0095062255859375,0.0095062255859375,0.0,37.53945474294951,92.81720395882836,98.39898305512499,26.235172310870098,-73.7648276891299,0.6520156495066516,1.207862670638616,-0.033908146169968734,309376300.0,-1.0
1080,ACGL,2024-06-14,92.48439025878906,94.50029043829008,92.37027982692341,93.56841396978334,1638600.0,-1.7972030639648438,1.7972030639648438,0.0,25.650731754022544,92.37027982692341,98.39898305512499,1.892785687838457,-98.10721431216155,0.38353866837408646,1.04299787018571,-0.043657771868213735,307737700.0,-1.0
1081,ACGL,2024-06-17,94.33863830566406,94.81408755058008,92.3702787219029,92.40831553206976,1176600.0,1.854248046875,0.0,1.854248046875,46.00717454940713,92.3702787219029,98.39898305512499,32.64979463189487,-67.35020536810514,0.3167398673129611,0.8977462696111602,-0.016359335488804083,308914300.0,1.0
1082,ACGL,2024-06-18,95.85057830810547,96.5352191812771,94.44324523900644,94.80458408218982,1489000.0,1.5119400024414062,0.0,1.5119400024414062,57.06665147252289,92.3702787219029,98.39898305512499,57.72881524515723,-42.27118475484278,0.3814056516642381,0.7944781460217758,0.011235993945137634,310403300.0,1.0
1083,ACGL,2024-06-20,97.41954803466797,97.47660687769074,96.05976289489836,96.1358365157422,1530700.0,1.5689697265625,0.0,1.5689697265625,65.52257845162862,92.3702787219029,98.39898305512499,83.75380568823563,-16.246194311764373,0.5528832027573998,0.7461591573689007,0.023680996999419834,311934000.0,1.0
1084,ACGL,2024-06-21,96.88704681396484,97.41004388671678,95.66989790441099,97.3054444721664,4271300.0,-0.532501220703125,0.532501220703125,0.0,60.83073536643081,92.3702787219029,98.01861970291797,79.96627872225635,-20.03372127774365,0.6384523183126731,0.7246177895576553,0.013125126648828145,307662700.0,-1.0
1085,ACGL,2024-06-24,97.4005355834961,97.6953118028327,96.2499492461726,96.88704951270397,1431000.0,0.51348876953125,0.0,0.51348876953125,63.72117535322268,92.3702787219029,97.6953118028327,94.46433074017371,-5.53566925982629,0.7391799053534811,0.7275302127168206,0.018393325540252192,309093700.0,1.0
1086,ACGL,2024-06-25,97.13428497314453,98.36094493078248,96.92508613861683,97.48611278141391,879700.0,-0.2662506103515625,0.2662506103515625,0.0,61.026867684257475,92.3702787219029,98.36094493078248,79.5238139654693,-20.4761860345307,0.7884344629744646,0.7397110627683495,0.025808398334739246,308214000.0,-1.0
1087,ACGL,2024-06-26,94.87113952636719,96.65883333762032,94.22452826044622,96.45914552451265,1370600.0,-2.2631454467773438,2.2631454467773438,0.0,43.13769939174031,92.3702787219029,98.36094493078248,41.745954744689634,-58.25404525531036,0.6375033888551087,0.7192695279857014,0.006151587804212433,306843400.0,-1.0
1088,ACGL,2024-06-27,96.05976867675781,96.24995274031464,94.36717041239324,95.31806896583673,1227600.0,1.188629150390625,0.0,1.188629150390625,51.715209512493495,92.3702787219029,98.36094493078248,61.587306423219104,-38.412693576780896,0.6068069708285861,0.6967770165542785,0.01886025990159812,308071000.0,1.0
1089,ACGL,2024-06-28,95.93614959716797,96.39258407170963,94.69997863865164,95.6603881601211,3818500.0,-0.12361907958984375,0.12361907958984375,0.0,50.79571129022632,92.3702787219029,98.36094493078248,59.52377834003845,-40.476221659961546,0.5659805404322213,0.6706177213298671,0.037322615510792856,304252500.0,-1.0
1090,ACGL,2024-07-01,95.70793914794922,97.31495274135467,95.64137654058663,96.96312492591531,1344700.0,-0.22821044921875,0.22821044921875,0.0,48.942122756153374,92.3702787219029,98.36094493078248,55.71434477686499,-44.28565522313502,0.5093392780423187,0.6383620326723575,0.014514740374442558,302907800.0,-1.0
1091,ACGL,2024-07-02,95.08985137939453,95.40364963009371,94.22453024954768,95.19445079629426,1249300.0,-0.6180877685546875,0.6180877685546875,0.0,43.93219233099399,92.3702787219029,98.36094493078248,45.39683171565426,-54.603168284345735,0.409851637618047,0.5926599536614954,-0.007936591955299721,301658500.0,-1.0
1092,ACGL,2024-07-03,92.85523986816406,95.28002668748134,92.56045640025599,95.01377626855519,1280000.0,-2.2346115112304688,2.2346115112304688,0.0,30.785958318217155,92.3702787219029,98.36094493078248,8.095279044963814,-91.9047209550362,0.14897519892403466,0.5039230027140033,-0.04685207700696414,300378500.0,-1.0
1093,ACGL,2024-07-05,93.3306884765625,93.53988730564753,92.31322737992335,93.07394182094734,1411100.0,0.4754486083984375,0.0,0.4754486083984375,35.52265001279112,92.31322737992335,98.36094493078248,16.82388583928846,-83.17611416071153,-0.019185372020118052,0.39930132776717897,-0.036706231166597436,301789600.0,1.0
1094,ACGL,2024-07-08,93.43529510498047,94.6809699046239,93.41627307098787,93.73007133884289,1335100.0,0.10460662841796875,0.0,0.10460662841796875,36.62371067354565,92.31322737992335,98.36094493078248,18.55357356921739,-81.44642643078261,-0.14237178206528256,0.2909667058006867,-0.040710664009813824,303124700.0,1.0
1095,ACGL,2024-07-09,93.18805694580078,94.18650331498927,93.12149433817355,93.3497079564983,1460700.0,-0.2472381591796875,0.2472381591796875,0.0,34.994031023171374,92.31322737992335,98.36094493078248,14.465450122636042,-85.53454987736396,-0.2569855828948988,0.18137624806156954,-0.04062652057854543,301664000.0,-1.0
1096,ACGL,2024-07-10,92.71260833740234,93.55890746389468,92.54144630874208,93.37823441842546,1047900.0,-0.4754486083984375,0.4754486083984375,0.0,31.849350938015647,92.31322737992335,98.36094493078248,6.603829529410822,-93.39617047058918,-0.38178163398239917,0.06874467165277579,-0.02275224267085918,300616100.0,-1.0
1097,ACGL,2024-07-11,92.2371597290039,92.77917161453983,91.01049972388992,92.61752060152286,1702300.0,-0.4754486083984375,0.4754486083984375,0.0,28.857193155568893,91.01049972388992,98.36094493078248,16.688240924015567,-83.31175907598444,-0.513133054347918,-0.04763087354736301,-0.03979406780186023,298913800.0,-1.0
1098,ACGL,2024-07-12,91.76171112060547,92.84573489957528,91.70465952848504,92.53193663335236,1557500.0,-0.4754486083984375,0.4754486083984375,0.0,26.03498440908386,91.01049972388992,98.36094493078248,10.219944174417238,-89.78005582558276,-0.6481235655111135,-0.16772941194011318,-0.0435126747747413,297356300.0,-1.0
1099,ACGL,2024-07-15,92.3893051147461,93.45430683056236,91.7712196162284,91.80925642819041,1271400.0,0.627593994140625,0.0,0.627593994140625,35.62415596060717,91.01049972388992,98.36094493078248,18.7581207946868,-81.24187920531321,-0.6964348603028441,-0.27347050161265946,-0.034674595051859214,298627700.0,1.0
1100,ACGL,2024-07-16,92.34175872802734,93.44479727302974,92.10403409063767,92.38930655741736,1100000.0,-0.04754638671875,0.04754638671875,0.0,35.22495477214916,91.01049972388992,97.31495274135467,21.11616980013231,-78.88383019986769,-0.7301418843901217,-0.36480477816815193,-0.028899957371924967,297527700.0,-1.0
1101,ACGL,2024-07-17,93.06443786621094,93.7871154954661,92.69358803534114,93.13100047034706,1049100.0,0.7226791381835938,0.0,0.7226791381835938,45.864136290151656,91.01049972388992,97.31495274135467,32.57916486380572,-67.42083513619428,-0.6905801983995303,-0.42995986221442767,0.002252947688723861,298576800.0,1.0
1102,ACGL,2024-07-18,93.41626739501953,94.32912909213023,92.893277568485,93.03590654086177,912300.0,0.35182952880859375,0.0,0.35182952880859375,50.43704335355075,91.01049972388992,97.31495274135467,38.15981599775734,-61.84018400224266,-0.6236485424233251,-0.4686975982562072,0.0009169429675697227,299489100.0,1.0
1103,ACGL,2024-07-19,91.38134765625,93.96779282920629,91.07706041559516,93.77761602433954,1029100.0,-2.0349197387695312,2.0349197387695312,0.0,32.25434225325475,91.01049972388992,97.31495274135467,5.88231732923929,-94.1176826707607,-0.7264318846523707,-0.52024445553544,-0.021982565008466293,298460000.0,-1.0
1104,ACGL,2024-07-22,91.8282699584961,92.45586646516797,91.08657027226933,91.40987228738152,973000.0,0.44692230224609375,0.0,0.44692230224609375,37.92529577575169,91.01049972388992,95.40364963009371,18.614667199299472,-81.38533280070052,-0.7630297966508977,-0.5688015237585315,-0.014591858998579177,299433000.0,1.0
1105,ACGL,2024-07-23,91.50496673583984,92.63653102857982,91.35281949206781,92.35126582867709,605300.0,-0.32330322265625,0.32330322265625,0.0,35.44845627929091,91.01049972388992,95.28002668748134,11.581306691971074,-88.41869330802894,-0.8087984486376882,-0.6168009087343629,-0.013025645844927713,298827700.0,-1.0
1106,ACGL,2024-07-24,91.66661834716797,92.74113105798578,91.51447110239026,92.23715600552451,1002400.0,0.161651611328125,0.0,0.161651611328125,37.79231192306133,91.01049972388992,94.6809699046239,17.875601516175383,-82.1243984838246,-0.8225447175397846,-0.6579496704954473,-0.006185591398436441,299830100.0,1.0
1107,ACGL,2024-07-25,89.83138275146484,92.10402959356338,89.54611029861388,91.97090438350756,1366800.0,-1.835235595703125,1.835235595703125,0.0,25.610688412681142,89.54611029861388,94.6809699046239,5.555603750432996,-94.444396249567,-0.9703414177038923,-0.7204280199371363,-0.021036316188606463,298463300.0,-1.0
1108,ACGL,2024-07-26,92.15158081054688,93.06444253655899,89.91696344216399,90.23076170088756,1108400.0,2.3201980590820312,0.0,2.3201980590820312,49.40191877604297,89.54611029861388,94.32912909213023,54.473348828669764,-45.526651171330236,-0.8899915066497925,-0.7543407172796677,-0.0025730716764670314,299571700.0,1.0
1109,ACGL,2024-07-29,92.24666595458984,93.00738040533601,91.90434191258113,92.15157755509405,1131100.0,0.09508514404296875,0.0,0.09508514404296875,50.15572062838998,89.54611029861388,94.32912909213023,56.46132228534658,-43.53867771465341,-0.8093118040866045,-0.7653349346410552,-0.0010297916646527794,300702800.0,1.0
1110,ACGL,2024-07-30,93.37823486328125,94.21503023173132,92.71260877908706,92.77917138750648,1505900.0,1.1315689086914062,0.0,1.1315689086914062,58.620645503316325,89.54611029861388,94.32912909213023,80.11937084299205,-19.88062915700794,-0.6466106791163071,-0.7415900835361057,0.0033718249877727757,302208700.0,1.0
1111,ACGL,2024-07-31,91.07705688476562,95.63186155611275,90.11664737142702,95.25150070634481,2449700.0,-2.301177978515625,2.301177978515625,0.0,41.91689481320145,89.54611029861388,95.63186155611275,25.156246474341327,-74.84375352565867,-0.6953392583617273,-0.73233991850123,-0.02504071908977412,299759000.0,-1.0
1112,ACGL,2024-08-01,92.33224487304688,92.44635530720721,89.46053453375471,91.45741997549085,2040000.0,1.25518798828125,0.0,1.25518798828125,50.749356879359624,89.46053453375471,95.63186155611275,46.53310914959249,-53.4668908504075,-0.6254638697211732,-0.7109647087452188,0.010405813015297971,301799000.0,1.0
1113,ACGL,2024-08-02,93.82515716552734,94.50980527483586,91.7807238543367,92.18961051657483,3584700.0,1.4929122924804688,0.0,1.4929122924804688,59.25293511591695,89.46053453375471,95.63186155611275,70.72421565021726,-29.275784349782747,-0.4444976829847178,-0.6576713035931187,0.021745887273426634,305383700.0,1.0
1114,ACGL,2024-08-05,91.34330749511719,95.63186175707261,89.77433077554454,95.4036481486442,2599900.0,-2.4818496704101562,2.4818496704101562,0.0,44.511210453492225,89.46053453375471,95.63186175707261,30.508396220646972,-69.49160377935303,-0.4956318672782203,-0.625263416330139,-0.001766671760991323,302783800.0,-1.0
1115,ACGL,2024-08-06,91.89483642578125,92.87426078360446,91.49546077099941,91.49546077099941,1402000.0,0.5515289306640625,0.0,0.5515289306640625,47.838778271174895,89.46053453375471,95.63186175707261,39.445354361193324,-60.55464563880667,-0.4860494261187114,-0.5974206182878535,0.00248965307904081,304185800.0,1.0
1116,ACGL,2024-08-07,92.04698181152344,93.15953136504815,91.61907311455074,91.63809514807673,1537200.0,0.1521453857421875,0.0,0.1521453857421875,48.81578180017787,89.46053453375471,95.63186175707261,41.91071359813862,-58.08928640186137,-0.4608658368762093,-0.5701096620055247,0.024663975909047897,305723000.0,1.0
1117,ACGL,2024-08-08,93.56842041015625,93.8631966442907,91.42889863517453,91.69514907307408,1091800.0,1.5214385986328125,0.0,1.5214385986328125,57.91181654205179,89.46053453375471,95.63186175707261,66.5640587146343,-33.4359412853657,-0.31451475097614434,-0.5189906797996486,0.015375098149669642,306814800.0,1.0
1118,ACGL,2024-08-09,93.93927001953125,94.09141001730394,93.06444508169238,93.56842015990867,737400.0,0.370849609375,0.0,0.370849609375,59.91530094706978,89.46053453375471,95.63186175707261,72.57329458813932,-27.42670541186069,-0.16668456097922046,-0.448529456035563,0.018348674691122335,307552200.0,1.0
1119,ACGL,2024-08-12,93.15953063964844,94.40520539903477,92.97885759645924,93.59694309519799,740700.0,-0.7797393798828125,0.7797393798828125,0.0,53.71233539425491,89.46053453375471,95.63186175707261,59.938421218653644,-40.061578781346356,-0.11116507990702473,-0.3810565808098553,-0.002342132767373717,306811500.0,-1.0
1120,ACGL,2024-08-13,92.93131256103516,93.72055279360345,92.05648043715577,93.72055279360345,848600.0,-0.22821807861328125,0.22821807861328125,0.0,51.89782578993962,89.46053453375471,95.63186175707261,56.24038236323571,-43.75961763676429,-0.08460550323090388,-0.32176636529406505,0.020359196264055912,305962900.0,-1.0
1121,ACGL,2024-08-14,95.94566345214844,96.07878866641586,93.17854523820415,93.17854523820415,1239100.0,3.0143508911132812,0.0,3.0143508911132812,68.24615125468745,89.46053453375471,96.07878866641586,97.98851462033697,-2.0114853796630263,0.17762848694010813,-0.2218873948472304,0.03913495858429372,307202000.0,1.0
1122,ACGL,2024-08-15,96.6588363647461,97.3244624292842,95.99320304542799,96.44963752881127,1076500.0,0.7131729125976562,0.0,0.7131729125976562,70.94215738887144,89.46053453375471,97.3244624292842,91.53570488716586,-8.464295112834135,0.4379494980569518,-0.08992001626639393,0.030201699467655052,308278500.0,1.0
1123,ACGL,2024-08-16,97.5146484375,97.84746147642652,96.54472786145111,97.28642756385311,801600.0,0.8558120727539062,0.0,0.8558120727539062,73.99882965539679,89.46053453375471,97.84746147642652,96.03176418250172,-3.9682358174982904,0.7051837376638019,0.0691007345196453,0.06756204818522371,309080100.0,1.0
1124,ACGL,2024-08-19,97.94255065917969,98.3894741384864,97.33397616750506,97.50513819671231,865200.0,0.4279022216796875,0.0,0.4279022216796875,75.48649407917756,89.46053453375471,98.3894741384864,94.99466343047183,-5.0053365695281595,0.9406536611631253,0.24341131984834136,0.0658112519551941,309945300.0,1.0
1125,ACGL,2024-08-20,97.75237274169922,98.21831099461657,97.25790143858762,97.91402375223257,700600.0,-0.19017791748046875,0.19017791748046875,0.0,73.33477535274187,89.46053453375471,98.3894741384864,92.86475858287172,-7.135241417128295,1.0992480561152718,0.4145786671017275,0.06198346559432233,309244700.0,-1.0
1126,ACGL,2024-08-21,99.46398162841797,99.57809206011504,97.91401968546012,98.13272227773807,1013200.0,1.71160888671875,0.0,1.71160888671875,79.42516368840796,89.77433077554454,99.57809206011504,98.83605456737648,-1.1639454326235188,1.347514481230661,0.6011658299275143,0.06300802335252187,310257900.0,1.0
1127,ACGL,2024-08-22,101.28020477294922,101.3087305681721,99.60662132366662,99.60662132366662,1144900.0,1.81622314453125,0.0,1.81622314453125,83.92149239711125,89.77433077554454,101.3087305681721,99.75268938362004,-0.24731061637996085,1.6715528203437344,0.8152432280107585,0.07814553755731435,311402800.0,1.0
1128,ACGL,2024-08-23,103.66695404052734,103.79057549188083,101.11854570242338,101.70810539985534,1514500.0,2.386749267578125,0.0,2.386749267578125,87.92329471628105,91.42889863517453,103.79057549188083,98.99996211851776,-1.000037881482241,2.096775929936044,1.071549768395816,0.11278956998530631,312917300.0,1.0
1129,ACGL,2024-08-26,104.11387634277344,104.71294705009134,103.49579085726478,103.63842708542523,1228000.0,0.44692230224609375,0.0,0.44692230224609375,88.53958238202783,91.42889863517453,104.71294705009134,95.49030018104116,-4.50969981895883,2.4416849780301817,1.3455768103226893,0.12033149509637919,314145300.0,1.0
1130,ACGL,2024-08-27,105.24545288085938,105.36906708190308,104.27553954204038,104.38013170921259,1446700.0,1.1315765380859375,0.0,1.1315765380859375,90.02648661105758,91.42889863517453,105.36906708190308,99.11325174070822,-0.886748259291783,2.7743556087429084,1.6313325700067334,0.09692766816239784,315592000.0,1.0
1131,ACGL,2024-08-28,105.55924987792969,106.08223972662563,104.72245451236789,105.64482726498204,990500.0,0.3137969970703125,0.0,0.3137969970703125,90.42402433112085,92.05648043715577,106.08223972662563,96.27121899141254,-3.728781008587454,3.028410642728673,1.9107481845511216,0.09208070206429464,316582500.0,1.0
1132,ACGL,2024-08-29,107.27085876464844,107.42300600878826,104.86508669123158,105.81598520276583,1341300.0,1.71160888671875,0.0,1.71160888671875,92.34449496354628,92.05648043715577,107.42300600878826,99.00987869098596,-0.9901213090140473,3.32948340798022,2.1944952292369417,0.10004866431325432,317923800.0,1.0
1133,ACGL,2024-08-30,107.537109375,108.07912849211023,106.65278072231678,107.42300619647567,2739400.0,0.2662506103515625,0.0,0.2662506103515625,92.61049043221661,92.05648043715577,108.07912849211023,96.61716892706367,-3.382831072936336,3.548663162687049,2.4653288159269633,0.09796108689478022,320663200.0,1.0
1134,ACGL,2024-09-03,107.68925476074219,108.66867905166453,107.09019131948925,107.53710751896251,1846600.0,0.1521453857421875,0.0,0.1521453857421875,92.77598923506726,93.17854523820415,108.66867905166453,93.6771089086961,-6.322891091303896,3.692081540733824,2.7106793608883355,0.10165361453987587,322509800.0,1.0
1135,ACGL,2024-09-04,107.75582122802734,109.020518015232,107.27086094594509,108.40243251921032,1124900.0,0.06656646728515625,0.0,0.06656646728515625,92.85675354847604,95.99320304542799,109.020518015232,90.29196123578731,-9.70803876421269,3.767681509064033,2.922079790523475,0.083365249046498,323634700.0,1.0
1136,ACGL,2024-09-05,106.68130493164062,108.04109007549488,105.91107221414764,107.65121820858388,1551500.0,-1.0745162963867188,1.0745162963867188,0.0,76.85344237804391,96.54472786145111,109.020518015232,81.2499805242199,-18.75001947578011,3.6982593123567113,3.077315694890123,0.053328290269551104,322083200.0,-1.0
1137,ACGL,2024-09-06,105.02674102783203,107.31840999560121,104.85557900013649,106.50063666936475,1211500.0,-1.6545639038085938,1.6545639038085938,0.0,58.83711803844691,97.25790143858762,109.020518015232,66.0468658365526,-33.953134163447395,3.4697352934091867,3.155799614593936,0.013116879915012314,320871700.0,-1.0
1138,ACGL,2024-09-09,106.243896484375,106.966574147375,105.15036171840858,105.73991416692014,1457100.0,1.2171554565429688,0.0,1.2171554565429688,65.66846705234411,97.25790143858762,109.020518015232,76.39452486813005,-23.60547513186994,3.348246137850765,3.1942889192453023,0.02045856149461689,322328800.0,1.0
1139,ACGL,2024-09-10,105.81598663330078,107.44202223943326,105.60678779717028,106.26291010052866,1118100.0,-0.42790985107421875,0.42790985107421875,0.0,61.52640696135963,97.91401968546012,109.020518015232,71.1472393297786,-28.852760670221407,3.1807704165970847,3.1915852187156593,0.005420982444602762,321210700.0,-1.0
1140,ACGL,2024-09-11,104.36111450195312,106.37702201339278,103.42923074299873,105.79697332507241,1308400.0,-1.4548721313476562,1.4548721313476562,0.0,49.32191075376158,99.60662132366662,109.020518015232,50.50504943979698,-49.49495056020302,2.897250973038993,3.1327183695803265,-0.011350358944025363,319902300.0,-1.0
1141,ACGL,2024-09-12,104.84607696533203,104.91263957415569,103.94271898297636,104.15191782635937,1198800.0,0.48496246337890625,0.0,0.48496246337890625,52.91426275282111,101.11854570242338,109.020518015232,47.17216304170733,-52.82783695829267,2.6807897140759565,3.042332638479453,-0.02260429185745927,321101100.0,1.0
1142,ACGL,2024-09-13,106.5196533203125,106.68131158887418,104.96018026491237,105.31201534324273,1487100.0,1.6735763549804688,0.0,1.6735763549804688,63.27900313440185,103.42923074299873,109.020518015232,55.272112249732366,-44.727887750267634,2.6141519159799884,2.9566964939795604,-0.009461441362901613,322588200.0,1.0
1143,ACGL,2024-09-16,108.61163330078125,108.77328431277535,107.40398808228382,107.40398808228382,996900.0,2.09197998046875,0.0,2.09197998046875,72.12804709409674,103.42923074299873,109.020518015232,92.68710952339543,-7.312890476604555,2.69903350376579,2.9051638959368065,0.00856518639755044,323585100.0,1.0
1144,ACGL,2024-09-17,108.36439514160156,109.05855425761568,108.00305631347833,108.50703137144336,991000.0,-0.2472381591796875,0.2472381591796875,0.0,69.83322064963072,103.42923074299873,109.05855425761568,87.66887150451232,-12.331128495487679,2.715055253535027,2.867142167456451,0.005647712639917479,322594100.0,-1.0
1145,ACGL,2024-09-18,107.48957061767578,108.65917174598388,106.88099613933431,108.58310537727623,891300.0,-0.8748245239257812,0.8748245239257812,0.0,61.804945400919365,103.42923074299873,109.05855425761568,72.12838033085292,-27.87161966914708,2.626880534168876,2.819089840798936,0.007576451061908962,321702800.0,-1.0
1146,ACGL,2024-09-19,105.94911193847656,107.75582058734393,105.56875107743396,107.52760697263038,1770100.0,-1.5404586791992188,1.5404586791992188,0.0,50.10206385477859,103.42923074299873,109.05855425761568,44.76348159658577,-55.23651840341424,2.4049762236846988,2.736267117376089,0.008782248231429923,319932700.0,-1.0
1147,ACGL,2024-09-20,107.67974853515625,107.85091056238356,105.22643581793824,106.07273493734549,3369100.0,1.7306365966796875,0.0,1.7306365966796875,59.936004398215864,103.42923074299873,109.05855425761568,75.5067244069512,-24.49327559304881,2.3417689143660425,2.65736747677408,0.013514678003102132,323301800.0,1.0
1148,ACGL,2024-09-23,108.07913208007812,108.40243410300313,107.64171236528053,108.0315842509279,1201000.0,0.399383544921875,0.0,0.399383544921875,61.93364990917823,103.42923074299873,109.05855425761568,82.60142315511952,-17.398576844880477,2.2974203489464173,2.5853780512085476,0.021387557010833724,324502800.0,1.0
1149,ACGL,2024-09-24,107.78434753417969,108.58310607638315,107.25184667589744,108.07913101339744,1091100.0,-0.2947845458984375,0.2947845458984375,0.0,59.410796646663684,103.42923074299873,109.05855425761568,77.36483397823162,-22.635166021768384,2.2129773171192397,2.5108979043906863,0.03280180600373428,323411700.0,-1.0
1150,ACGL,2024-09-25,107.51809692382812,108.31685546468536,107.09019548554109,108.10765662648988,1052800.0,-0.2662506103515625,0.2662506103515625,0.0,56.99139265450242,103.42923074299873,109.05855425761568,72.6351251657922,-27.364874834207797,2.1003597669460277,2.4287902769017546,0.025485168695244642,322358900.0,-1.0
1151,ACGL,2024-09-26,107.04264831542969,108.06962047937225,106.5862138243063,106.71934629425155,1441000.0,-0.4754486083984375,0.4754486083984375,0.0,52.5795430458258,103.42923074299873,109.05855425761568,64.18919721079193,-35.810802789208076,1.9502633954344333,2.3330849006082905,0.004909845073795882,320917900.0,-1.0
1152,ACGL,2024-09-27,107.8414077758789,108.08863617483672,106.94756081952015,107.19479647325814,1356200.0,0.7987594604492188,0.0,0.7987594604492188,58.767055929044574,103.42923074299873,109.05855425761568,78.37845917761939,-21.621540822380613,1.874160002685585,2.2412999210237494,-0.007091556415226186,322274100.0,1.0
1153,ACGL,2024-09-30,106.38652801513672,107.95551208617067,104.64638916831969,107.80337208943673,2391400.0,-1.4548797607421875,1.4548797607421875,0.0,46.11978893870515,103.42923074299873,109.05855425761568,52.533794948170076,-47.46620505182993,1.6771181043452401,2.1284635576880477,-0.01825200171957153,319882700.0,-1.0
1154,ACGL,2024-10-01,107.93649291992188,108.44997899074069,105.91107443145098,106.30094630652415,1238200.0,1.5499649047851562,0.0,1.5499649047851562,57.39174259375224,103.94271898297636,109.05855425761568,78.06689861074709,-21.933101389252904,1.6272720156643459,2.0282252492833073,0.0041578201464376185,321120900.0,1.0
1155,ACGL,2024-10-02,108.15519714355469,108.83033423160755,107.54662266264,107.9364945435779,961500.0,0.2187042236328125,0.0,0.2187042236328125,58.79520528859186,104.64638916831969,109.05855425761568,79.52576352474756,-20.474236475252436,1.587120892621087,1.9400043779508631,0.020822120777748143,322082400.0,1.0
1156,ACGL,2024-10-03,107.30889892578125,108.27881950050306,107.21381052261522,107.81287399186331,891100.0,-0.8462982177734375,0.8462982177734375,0.0,51.25690184239835,104.64638916831969,109.05855425761568,60.34474466789258,-39.65525533210742,1.4700656433189891,1.8460166310244885,-0.003444005158072194,321191300.0,-1.0
1157,ACGL,2024-10-04,109.22020721435547,109.38185822549603,106.50063680136674,106.68130984604156,1293200.0,1.9113082885742188,0.0,1.9113082885742188,63.46390497859407,104.64638916831969,109.38185822549603,96.5863780506476,-3.413621949352405,1.5140718426031015,1.7796276733402112,0.010557774774059947,322484500.0,1.0
1158,ACGL,2024-10-07,102.49735260009766,110.75115206472312,101.47038045475817,109.59105470663,3264600.0,-6.7228546142578125,6.7228546142578125,0.0,31.47378813409709,101.47038045475817,110.75115206472312,11.065590109305193,-88.93440989069481,0.994999159507671,1.6227019705737034,-0.04905160215777582,319219900.0,-1.0
1159,ACGL,2024-10-08,104.51325988769531,105.25495957304291,103.36266629349407,103.36266629349407,2177800.0,2.0159072875976562,0.0,2.0159072875976562,41.65016954387846,101.47038045475817,110.75115206472312,32.7869229070344,-67.2130770929656,0.7377923776371915,1.445720051986401,-0.027947267688913868,321397700.0,1.0
1160,ACGL,2024-10-09,107.537109375,107.68925661940567,103.99977299992737,104.15191298955311,2072500.0,3.0238494873046875,0.0,3.0238494873046875,53.58098425433766,101.47038045475817,110.75115206472312,65.3687987939264,-34.63120120607359,0.7690879648725115,1.3103936345636233,0.004619290230126305,323470200.0,1.0
1161,ACGL,2024-10-10,108.30734252929688,110.69409983812987,107.56564284685618,110.0379775399185,1352200.0,0.770233154296875,0.0,0.770233154296875,56.2124121215097,101.47038045475817,110.75115206472312,73.66803496379251,-26.33196503620749,0.8462858650164833,1.2175720806541954,0.004320555184018859,324822400.0,1.0
1162,ACGL,2024-10-11,108.78279113769531,109.41038038263325,108.40243028224025,108.9919899709346,1452300.0,0.4754486083984375,0.0,0.4754486083984375,57.91177238255838,101.47038045475817,110.75115206472312,78.79097762825738,-21.20902237174262,0.9350517912691458,1.1610680227771855,0.022524121872063096,326274700.0,1.0
1163,ACGL,2024-10-14,105.63531494140625,107.54662303118052,103.609903670307,107.54662303118052,2677000.0,-3.1474761962890625,3.1474761962890625,0.0,44.66974009779279,101.47038045475817,110.75115206472312,44.87702813606692,-55.12297186393308,0.7428611618056493,1.0774266505828782,-0.021319740119987718,323597700.0,-1.0
1164,ACGL,2024-10-15,102.75408935546875,105.87303526763156,102.6780229892739,105.71138426414528,2561800.0,-2.8812255859375,2.8812255859375,0.0,35.979921470179974,101.47038045475817,110.75115206472312,13.83191995945936,-86.16808004054064,0.3539774462616805,0.9327368097186387,-0.049938495150788076,321035900.0,-1.0
1165,ACGL,2024-10-16,102.19306945800781,104.29455440614551,102.05043322297632,102.76360714335347,1696200.0,-0.5610198974609375,0.5610198974609375,0.0,34.473217228512624,101.47038045475817,110.75115206472312,7.786949551410964,-92.21305044858904,0.0005088175193748157,0.746291211278786,-0.047673860406598045,319339700.0,-1.0
1166,ACGL,2024-10-17,102.93476867675781,103.77155679423366,102.19306896391646,102.78262142551844,1954000.0,0.74169921875,0.0,0.74169921875,38.40773438267516,101.47038045475817,110.75115206472312,15.778733531458736,-84.22126646854127,-0.2172642025638396,0.5535801285102608,-0.057548311781370876,321293700.0,1.0
1167,ACGL,2024-10-18,103.20101928710938,103.34365552169375,102.35472015129713,103.14396769518773,4339400.0,0.2662506103515625,0.0,0.2662506103515625,39.90238784146741,101.47038045475817,110.75115206472312,18.647574847041636,-81.35242515295836,-0.36416877983673146,0.37003034684086233,0.006865218165752474,325633100.0,1.0
1168,ACGL,2024-10-21,103.17249298095703,104.22799095496951,102.65900689186067,103.20101877677679,1302300.0,-0.02852630615234375,0.02852630615234375,0.0,39.78303984567922,101.47038045475817,110.75115206472312,18.340204863691174,-81.65979513630883,-0.47739048981668475,0.2005461795093529,-0.012828677511150244,324330800.0,-1.0
1169,ACGL,2024-10-22,102.49735260009766,103.3911995326835,101.22314480759572,103.0298534511122,1078400.0,-0.675140380859375,0.675140380859375,0.0,36.778955716171616,101.22314480759572,110.75115206472312,13.373287384397955,-86.62671261560205,-0.6145139626066651,0.03753415108614927,-0.04686528031293702,323252400.0,-1.0
1170,ACGL,2024-10-23,101.74613952636719,102.61146064388575,101.14707608293267,102.29766239765726,1635400.0,-0.7512130737304688,0.7512130737304688,0.0,33.52849347140642,101.14707608293267,110.75115206472312,6.237595835042906,-93.76240416495709,-0.7748697040062922,-0.12494661993233906,-0.060579484730270194,321617000.0,-1.0
1171,ACGL,2024-10-24,101.7841796875,102.59244198836001,101.5939956283223,102.0599411322226,1467400.0,0.0380401611328125,0.0,0.0380401611328125,33.86997837866325,101.14707608293267,110.75115206472312,6.633679343804576,-93.36632065619543,-0.8886395773885027,-0.2776852114235719,-0.06433564883747644,323084400.0,1.0
1172,ACGL,2024-10-25,100.1296157836914,101.92681338323838,99.74925492957577,101.44185311287146,1490100.0,-1.6545639038085938,1.6545639038085938,0.0,26.927416184766315,99.74925492957577,110.69409983812987,3.475251200849451,-96.52474879915054,-1.099636575044343,-0.4420754841477261,-0.05211987260859441,321594300.0,-1.0
1173,ACGL,2024-10-28,100.47193908691406,101.11854310293438,100.22470344534288,100.35782865508587,1224700.0,0.34232330322265625,0.0,0.34232330322265625,30.336300170096138,99.74925492957577,110.69409983812987,6.602963891918362,-93.39703610808164,-1.2251083003005903,-0.598682047378299,-0.022209824279204926,322819000.0,1.0
1174,ACGL,2024-10-29,99.65416717529297,101.39430594238816,99.54005674188511,100.72867988445884,1316800.0,-0.8177719116210938,0.8177719116210938,0.0,26.879864599208133,99.54005674188511,110.69409983812987,1.023040994402081,-98.97695900559792,-1.3746863765674107,-0.7538829132161214,-0.0248441728600598,321502200.0,-1.0
1175,ACGL,2024-10-30,99.97747039794922,100.56703009552284,98.89344665918289,99.51153215175877,1727400.0,0.32330322265625,0.0,0.32330322265625,30.49249319051259,98.89344665918289,109.41038038263325,10.307412476596745,-89.69258752340326,-1.4504206649797595,-0.8931904635688492,-0.028729828772387722,323229600.0,1.0
1176,ACGL,2024-10-31,93.7205581665039,98.1422378466539,93.44479671819562,97.10576191608355,3438200.0,-6.2569122314453125,6.2569122314453125,0.0,14.497616939644828,93.44479671819562,107.54662303118052,1.9555016647337915,-98.04449833526621,-1.992354537156217,-1.1130232782863227,-0.09186402601538701,319791400.0,-1.0
1177,ACGL,2024-11-01,91.3052749633789,94.46225783790547,91.15313496889023,93.73006915144468,4006500.0,-2.415283203125,2.415283203125,0.0,11.751919587498875,91.15313496889023,105.87303526763156,1.0335667457047057,-98.9664332542953,-2.586913871593268,-1.407801396947712,-0.11502308100443503,315784900.0,-1.0
1178,ACGL,2024-11-04,90.33535766601562,91.5525065874877,90.28780983901632,91.43840341033707,2293300.0,-0.9699172973632812,0.9699172973632812,0.0,10.80383208815006,90.28780983901632,104.29455440614551,0.3394637973972243,-99.66053620260278,-3.100628532020565,-1.7463668239622825,-0.11865667381218237,313491600.0,-1.0
1179,ACGL,2024-11-05,91.76171112060547,91.78072589971885,90.3829111093064,90.56357690261451,1906700.0,1.4263534545898438,0.0,1.4263534545898438,21.54389256278901,90.28780983901632,104.22799095496951,10.573042554679665,-89.42695744532033,-3.3539935484334364,-2.0678921688565133,-0.09813078365665451,315398300.0,1.0
1180,ACGL,2024-11-06,96.70637512207031,96.96312178127089,95.23248679119023,96.87753714327741,3283100.0,4.944664001464844,0.0,4.944664001464844,47.04761568054747,90.28780983901632,104.22799095496951,46.04362905807991,-53.956370941920085,-3.1198306233017803,-2.2782798597455667,-0.04988795489652398,318681400.0,1.0
1181,ACGL,2024-11-07,94.89967346191406,97.1437945084448,94.82359984055849,96.8585220557513,2048900.0,-1.80670166015625,1.80670166015625,0.0,41.37696351524848,90.28780983901632,104.22799095496951,33.08324034341211,-66.91675965658789,-3.0449403656948277,-2.431611960935419,-0.05223172266111076,316632500.0,-1.0
1182,ACGL,2024-11-08,96.84901428222656,98.10420005750224,96.04075197890467,97.41955195193731,1887200.0,1.9493408203125,0.0,1.9493408203125,49.0257949793676,90.28780983901632,103.3911995326835,50.07257355996402,-49.92742644003598,-2.7960625159129506,-2.5045020719309257,-0.036059071195525094,318519700.0,1.0
1183,ACGL,2024-11-11,95.56529998779297,97.47660801888719,95.15641333944505,97.2483871536838,2131700.0,-1.2837142944335938,1.2837142944335938,0.0,44.60371752258366,90.28780983901632,102.61146064388575,42.82408056134925,-57.17591943865076,-2.671613346370137,-2.537924326818768,-0.04103056905094227,316388000.0,-1.0
1184,ACGL,2024-11-12,96.15486145019531,96.3830750648343,95.28002929364918,95.57481276962038,2402000.0,0.5895614624023438,0.0,0.5895614624023438,47.13076468142969,90.28780983901632,102.59244198836001,47.68164980447573,-52.31835019552427,-2.496634155609385,-2.5296662925768914,-0.03823470360410641,318790000.0,1.0
1185,ACGL,2024-11-13,96.2119140625,97.11526476884744,95.80302740225451,96.24043985778549,1736000.0,0.0570526123046875,0.0,0.0570526123046875,47.398696066592635,90.28780983901632,101.92681338323838,50.898723425722956,-49.101276574277044,-2.3265393202072033,-2.489040898102954,0.026582811122080052,320526000.0,1.0
1186,ACGL,2024-11-14,95.13739776611328,97.09624635333192,94.74752589906812,96.38307247878768,2165600.0,-1.0745162963867188,1.0745162963867188,0.0,42.6965245693059,90.28780983901632,101.39430594238816,43.66442739420462,-56.33557260579538,-2.252477266880689,-2.441728171858501,0.04197044260883476,318360400.0,-1.0
1187,ACGL,2024-11-15,96.83000183105469,97.34348792257057,95.60334182156345,95.60334182156345,2726400.0,1.6926040649414062,0.0,1.6926040649414062,51.45053053783926,90.28780983901632,101.39430594238816,58.90419382627986,-41.095806173720135,-2.033759638531194,-2.3601344651930396,0.07189481873809367,321086800.0,1.0
1188,ACGL,2024-11-18,96.9800033569336,97.1500015258789,95.75,96.55000305175781,2255800.0,0.15000152587890625,0.0,0.15000152587890625,52.197266067328634,90.28780983901632,100.56703009552284,65.10409691514553,-34.895903084854474,-1.8272569915943109,-2.253558970473294,0.056867861034866074,323342600.0,1.0
1189,ACGL,2024-11-19,95.69000244140625,96.58999633789062,95.27999877929688,96.08999633789062,1554600.0,-1.2900009155273438,1.2900009155273438,0.0,45.2855730164617,90.28780983901632,98.1422378466539,68.7789435097869,-31.221056490213105,-1.747549782935451,-2.1523571329657254,-0.010509882925309966,321788000.0,-1.0
1190,ACGL,2024-11-20,95.70999908447266,96.02999877929688,94.0,95.83000183105469,2889900.0,0.01999664306640625,0.0,0.01999664306640625,45.4148514751068,90.28780983901632,98.10420005750224,69.36947995038362,-30.630520049616383,-1.6635908441354985,-2.05460387519968,0.008538760914533539,324677900.0,1.0
1191,ACGL,2024-11-21,98.58999633789062,98.77999877929688,95.5199966430664,95.66000366210938,1923700.0,2.8799972534179688,0.0,2.8799972534179688,60.80487413514234,90.28780983901632,98.77999877929688,97.76262112463111,-2.2373788753688855,-1.3491093779183245,-1.9135049757434088,0.017976249614587658,326601600.0,1.0
1192,ACGL,2024-11-22,99.69000244140625,99.80000305175781,98.02999877929688,98.62000274658203,1569600.0,1.100006103515625,0.0,1.100006103515625,65.13681705850601,90.3829111093064,99.80000305175781,98.83190467902634,-1.1680953209736606,-0.9995965243005429,-1.730723285454836,0.043161089371771544,328171200.0,1.0
1193,ACGL,2024-11-25,100.05999755859375,100.62000274658203,98.83000183105469,99.91000366210938,4050500.0,0.3699951171875,0.0,0.3699951171875,66.57074131989984,94.0,100.62000274658203,91.54071063977402,-8.459289360225977,-0.6848549740915928,-1.5215496231821874,0.04061298669148572,332221700.0,1.0
1194,ACGL,2024-11-26,100.41000366210938,100.69000244140625,99.41999816894531,100.0999984741211,1269200.0,0.350006103515625,0.0,0.350006103515625,68.00702851543575,94.0,100.69000244140625,95.81466850349881,-4.1853314965012,-0.40253726154953995,-1.297747150855658,0.04363378112280625,333490900.0,1.0
1195,ACGL,2024-11-27,100.73999786376953,101.66000366210938,100.4800033569336,100.79000091552734,991500.0,0.32999420166015625,0.0,0.32999420166015625,69.43562211884858,94.0,101.66000366210938,87.98948618144006,-12.010513818559938,-0.15043652752746084,-1.0682850261900185,0.058889566345189825,334482400.0,1.0
1196,ACGL,2024-11-29,100.72000122070312,101.27999877929688,100.2699966430664,100.83000183105469,797200.0,-0.01999664306640625,0.01999664306640625,0.0,69.21950890168355,94.0,101.66000366210938,87.72843352469891,-12.271566475301093,0.04719749515150795,-0.8451885219217132,0.040173492885351436,333685200.0,-1.0
1197,ACGL,2024-12-02,99.30000305175781,100.93000030517578,99.26000213623047,100.58999633789062,1472400.0,-1.4199981689453125,1.4199981689453125,0.0,55.15402170675668,94.0,101.66000366210938,69.19060728357829,-30.80939271642172,0.08822489550946955,-0.6585058384354766,0.023922454263952675,332212800.0,-1.0
1198,ACGL,2024-12-03,99.52999877929688,100.4800033569336,98.69000244140625,100.0,1966600.0,0.2299957275390625,0.0,0.2299957275390625,56.79477188211752,94.0,101.66000366210938,72.19316103791587,-27.806838962084118,0.13771069575875572,-0.49926253159663014,0.04012954582420414,334179400.0,1.0
1199,ACGL,2024-12-04,98.4800033569336,99.98999786376953,98.29000091552734,99.73999786376953,1553300.0,-1.0499954223632812,1.0499954223632812,0.0,47.61772157902062,94.0,101.66000366210938,58.48565554993367,-41.51434445006633,0.09115195062868509,-0.3811796351515671,0.028941639316244938,332626100.0,-1.0
1200,ACGL,2024-12-05,98.48999786376953,99.30999755859375,98.30999755859375,98.86000061035156,1379100.0,0.0099945068359375,0.0,0.0099945068359375,47.710517943747156,94.0,101.66000366210938,58.61613207810266,-41.38386792189735,0.05443281523869814,-0.29405714507351405,-0.0010142862139722597,334005200.0,1.0
1201,ACGL,2024-12-06,97.83000183105469,98.80999755859375,97.01000213623047,98.45999908447266,1398300.0,-0.6599960327148438,0.6599960327148438,0.0,42.036381605174185,94.0,101.66000366210938,50.0,-50.0,-0.02760531128325283,-0.2407667783154618,-0.01865784496740075,332606900.0,-1.0
1202,ACGL,2024-12-09,95.9000015258789,97.69999694824219,95.72000122070312,97.38999938964844,1805500.0,-1.9300003051757812,1.9300003051757812,0.0,29.99851845846679,94.0,101.66000366210938,24.80418560734334,-75.19581439265666,-0.24552574459758603,-0.24171857157188667,-0.041575016332364045,330801400.0,-1.0
1203,ACGL,2024-12-10,93.3499984741211,95.9000015258789,92.30999755859375,95.25,1869800.0,-2.5500030517578125,2.5500030517578125,0.0,20.88202365932274,92.30999755859375,101.66000366210938,11.122997183245698,-88.8770028167543,-0.6168821595043426,-0.3167512891583779,-0.07031177104370967,328931600.0,-1.0
1204,ACGL,2024-12-11,94.06999969482422,94.12000274658203,92.41999816894531,93.55999755859375,1516100.0,0.720001220703125,0.0,0.720001220703125,28.00961837177813,92.30999755859375,101.66000366210938,18.823539971473426,-81.17646002852658,-0.843364926688551,-0.4220740166644126,-0.06621002889006544,330447700.0,1.0
1205,ACGL,2024-12-12,93.91999816894531,95.36000061035156,93.66999816894531,94.2300033569336,1449200.0,-0.15000152587890625,0.15000152587890625,0.0,27.415899736391694,92.30999755859375,101.66000366210938,17.219246624301114,-82.7807533756989,-1.0231636275247666,-0.5422919388364834,-0.06751392940174095,328998500.0,-1.0
1206,ACGL,2024-12-13,93.41999816894531,94.33000183105469,93.36000061035156,94.16999816894531,2067200.0,-0.5,0.5,0.0,25.349276572480704,92.30999755859375,101.66000366210938,11.871656532226215,-88.12834346777379,-1.1922576110571157,-0.6722850732806099,-0.05921454886308197,326931300.0,-1.0
1207,ACGL,2024-12-16,91.33999633789062,93.41999816894531,91.16999816894531,93.4000015258789,2771800.0,-2.0800018310546875,2.0800018310546875,0.0,18.61417440439044,91.16999816894531,101.66000366210938,1.6205727352201469,-98.37942726477985,-1.4770777429565527,-0.8332436072157985,-0.08228677325282796,324159500.0,-1.0
1208,ACGL,2024-12-17,90.52999877929688,90.87000274658203,89.87999725341797,90.83999633789062,2487800.0,-0.80999755859375,0.80999755859375,0.0,16.62894289515684,89.87999725341797,101.66000366210938,5.517836776381791,-94.48216322361822,-1.7480098140139546,-1.0161968485754298,-0.08072709490902952,321671700.0,-1.0
1209,ACGL,2024-12-18,88.70999908447266,90.9800033569336,88.66999816894531,90.80999755859375,2008900.0,-1.8199996948242188,1.8199996948242188,0.0,13.026931889519105,88.66999816894531,101.27999877929688,0.3172158096051713,-99.68278419039483,-2.085543351734202,-1.2300661492071843,-0.09929941102064477,319662800.0,-1.0
1210,ACGL,2024-12-19,88.98999786376953,90.02999877929688,88.83000183105469,88.83000183105469,2120800.0,0.279998779296875,0.0,0.279998779296875,16.247345859231928,88.66999816894531,100.93000030517578,2.6101112485010356,-97.38988875149897,-2.303889743887538,-1.4448308681432551,-0.09036086887283512,321783600.0,1.0
1211,ACGL,2024-12-20,90.98999786376953,91.3499984741211,88.52999877929688,88.62999725341797,5114300.0,2.0,0.0,2.0,35.83031650054592,88.52999877929688,100.4800033569336,20.585758511559966,-79.41424148844004,-2.289159541228315,-1.6136966027602673,-0.05119920316981852,326897900.0,1.0
1212,ACGL,2024-12-23,92.08999633789062,92.19000244140625,90.08999633789062,90.08999633789062,1729800.0,1.0999984741210938,0.0,1.0999984741210938,44.12180257324867,88.52999877929688,99.98999786376953,31.06455360382402,-68.93544639617598,-2.163782329913232,-1.7237137481908604,-0.013497612820848381,328627700.0,1.0
1213,ACGL,2024-12-24,92.66999816894531,92.73999786376953,91.87000274658203,92.33999633789062,767100.0,0.5800018310546875,0.0,0.5800018310546875,48.1943382069605,88.52999877929688,99.30999755859375,38.40445137711295,-61.59554862288705,-1.9946258806231185,-1.7778961746773119,-0.01488255055193688,329394800.0,1.0
1214,ACGL,2024-12-26,92.93000030517578,93.11000061035156,92.08000183105469,92.51000213623047,842800.0,0.26000213623046875,0.0,0.26000213623046875,50.07635815547045,88.52999877929688,98.80999755859375,42.80157634590551,-57.19842365409449,-1.8186242085669022,-1.7860417814552298,-0.01054086332059656,330237600.0,1.0
1215,ACGL,2024-12-27,92.33999633789062,93.16000366210938,91.91999816894531,92.37000274658203,1030500.0,-0.5900039672851562,0.5900039672851562,0.0,45.726812921354686,88.52999877929688,97.69999694824219,41.548509480585395,-58.451490519414605,-1.707071941997853,-1.7702478135637547,-0.011560713468454109,329207100.0,-1.0
1216,ACGL,2024-12-30,91.88999938964844,92.23999786376953,90.80000305175781,91.77999877929688,1010000.0,-0.4499969482421875,0.4499969482421875,0.0,42.479715924643386,88.52999877929688,95.9000015258789,45.59022195629197,-54.40977804370804,-1.6361168236967103,-1.743421615590346,0.006021491940104928,328197100.0,-1.0
1217,ACGL,2024-12-31,92.3499984741211,92.47000122070312,91.66000366210938,92.4000015258789,1095200.0,0.45999908447265625,0.0,0.45999908447265625,46.925095559361765,88.52999877929688,95.36000061035156,55.92970235315933,-44.07029764684067,-1.5251849171644096,-1.6997742759051588,0.02010382988363002,329292300.0,1.0
1218,ACGL,2025-01-02,91.37999725341797,93.04000091552734,91.18000030517578,92.94999694824219,1029800.0,-0.970001220703125,0.970001220703125,0.0,39.49789711519257,88.52999877929688,95.36000061035156,41.72763850754338,-58.27236149245662,-1.498270444841495,-1.659473509692426,0.03009805204036642,328262500.0,-1.0
1219,ACGL,2025-01-03,91.4000015258789,92.01000213623047,90.87999725341797,91.62999725341797,1624700.0,0.0200042724609375,0.0,0.0200042724609375,39.72491292094908,88.52999877929688,94.33000183105469,49.48277993943842,-50.51722006056158,-1.4585135180691822,-1.6192815113677772,0.027081736374448884,329887200.0,1.0
1220,ACGL,2025-01-06,90.73999786376953,92.01000213623047,90.5199966430664,91.29000091552734,1791000.0,-0.660003662109375,0.660003662109375,0.0,34.75974742384295,88.52999877929688,93.41999816894531,45.19426094716839,-54.80573905283161,-1.46339355682818,-1.588103920459858,-0.0027475547408442047,328096200.0,-1.0
1221,ACGL,2025-01-07,92.25,93.25,90.58000183105469,90.73999786376953,2144200.0,1.5100021362304688,0.0,1.5100021362304688,50.94538382502908,88.52999877929688,93.25,78.81356480134484,-21.186435198655158,-1.3300840885004135,-1.5364999540679691,0.0017374706099704262,330240400.0,1.0
1222,ACGL,2025-01-08,92.66000366210938,93.0,91.33999633789062,92.41999816894531,1698000.0,0.410003662109375,0.0,0.410003662109375,54.48326565414187,88.52999877929688,93.25,87.50008081983643,-12.49991918016358,-1.1777748500867204,-1.4647549332717196,-0.00010785051293205061,331938400.0,1.0
1223,ACGL,2025-01-10,90.16999816894531,92.0,89.9000015258789,91.04000091552734,2896400.0,-2.4900054931640625,2.4900054931640625,0.0,36.19220303705671,88.52999877929688,93.25,34.74574079462063,-65.25425920537937,-1.2436552314100453,-1.420534992899385,-0.029699796913448928,329042000.0,-1.0
1224,ACGL,2025-01-13,90.83000183105469,91.33000183105469,89.47000122070312,89.83999633789062,1512600.0,0.660003662109375,0.0,0.660003662109375,42.133694880966196,88.52999877929688,93.25,48.728865612776,-51.271134387224,-1.228448340809507,-1.3821176624814095,-0.01635255107993039,330554600.0,1.0
1225,ACGL,2025-01-14,91.98999786376953,92.19999694824219,89.97000122070312,91.12000274658203,2493700.0,1.1599960327148438,0.0,1.1599960327148438,51.325153047939786,89.47000122070312,93.25,66.66659938803356,-33.33340061196645,-1.109999402933724,-1.3276940105718726,0.001088241101156795,333048300.0,1.0
1226,ACGL,2025-01-15,93.62000274658203,93.76000213623047,92.73999786376953,93.0999984741211,1955500.0,1.6300048828125,0.0,1.6300048828125,61.29349502691361,89.47000122070312,93.76000213623047,96.73661166034441,-3.263388339655592,-0.8745190831436105,-1.2370590250862203,0.013752076810448655,335003800.0,1.0
1227,ACGL,2025-01-16,96.0999984741211,96.16999816894531,93.75,93.87999725341797,1847200.0,2.4799957275390625,0.0,2.4799957275390625,71.52937646457636,89.47000122070312,96.16999816894531,98.95522795958013,-1.0447720404198673,-0.48222550865375524,-1.0860923217997274,0.051652455269980635,336851000.0,1.0
1228,ACGL,2025-01-17,95.51000213623047,96.83999633789062,95.41999816894531,96.18000030517578,4619700.0,-0.589996337890625,0.589996337890625,0.0,66.68834902174925,89.47000122070312,96.83999633789062,81.95393374741201,-18.04606625258799,-0.2164427805671778,-0.9121624135532175,0.044967183169990044,332231300.0,-1.0
1229,ACGL,2025-01-21,94.87999725341797,96.5199966430664,94.70999908447266,96.0,1694100.0,-0.6300048828125,0.6300048828125,0.0,61.5554565288333,89.47000122070312,96.83999633789062,73.40569358178054,-26.59430641821946,-0.05599866481981053,-0.7409296638065361,0.04562485659151028,330537200.0,-1.0
1230,ACGL,2025-01-22,93.20999908447266,95.01000213623047,93.05999755859375,94.9000015258789,1912500.0,-1.6699981689453125,1.6699981689453125,0.0,49.825774337710435,89.47000122070312,96.83999633789062,50.74627329192547,-49.25372670807454,-0.06287565126042693,-0.6053188612973144,0.010406494140625,328624700.0,-1.0
1231,ACGL,2025-01-23,93.0199966430664,93.73999786376953,92.80999755859375,93.43000030517578,1158800.0,-0.19000244140625,0.19000244140625,0.0,48.60977211999445,89.47000122070312,96.83999633789062,48.16821946169772,-51.831780538302276,-0.0827039618744152,-0.5007958814127346,0.003885095691014362,327465900.0,-1.0
1232,ACGL,2025-01-24,92.76000213623047,93.55000305175781,92.0,92.97000122070312,1334600.0,-0.2599945068359375,0.2599945068359375,0.0,46.80618768916248,89.47000122070312,96.83999633789062,44.64047619047619,-55.359523809523814,-0.11803677031529958,-0.42424405919324754,0.028723566816896806,326131300.0,-1.0
1233,ACGL,2025-01-27,96.5199966430664,96.52999877929688,93.18000030517578,93.27999877929688,1899300.0,3.7599945068359375,0.0,3.7599945068359375,67.14672747211546,89.47000122070312,96.83999633789062,95.65807453416149,-4.34192546583851,0.15556856003064468,-0.3082815353484691,0.06264444233520106,328030600.0,1.0
1234,ACGL,2025-01-28,95.20999908447266,96.83000183105469,94.83000183105469,96.19999694824219,1626100.0,-1.30999755859375,1.30999755859375,0.0,58.20015505893474,89.47000122070312,96.83999633789062,77.88333333333334,-22.116666666666667,0.2636576197582343,-0.19389370432712838,0.03500381884421522,326404500.0,-1.0
1235,ACGL,2025-01-29,93.81999969482422,95.16999816894531,93.45999908447266,94.83999633789062,2247300.0,-1.3899993896484375,1.3899993896484375,0.0,50.03769360118388,89.47000122070312,96.83999633789062,59.023084886128366,-40.976915113871634,0.23445499307989337,-0.10822396484572402,0.0021362630033621155,324157200.0,-1.0
1236,ACGL,2025-01-30,94.58000183105469,95.05000305175781,92.86000061035156,94.37000274658203,1556800.0,0.7600021362304688,0.0,0.7600021362304688,54.0990129204329,89.47000122070312,96.83999633789062,69.3351966873706,-30.664803312629402,0.2695305415288658,-0.03267306357080604,-0.015816822759635363,325714000.0,1.0
1237,ACGL,2025-01-31,93.06999969482422,94.61000061035156,92.33999633789062,93.94999694824219,2040600.0,-1.5100021362304688,1.5100021362304688,0.0,45.601127106867125,89.47000122070312,96.83999633789062,48.846687370600414,-51.153312629399586,0.17348380034054856,0.008558309211464896,-0.025547088125136397,323673400.0,-1.0
1238,ACGL,2025-02-03,93.0999984741211,93.5,91.16000366210938,92.56999969482422,2056400.0,0.029998779296875,0.0,0.029998779296875,45.79630219909976,89.97000122070312,96.83999633789062,45.56039997157021,-54.439600028429794,0.09864954618716126,0.026576556606604178,-0.018760527306325936,325729800.0,1.0
1239,ACGL,2025-02-04,92.7699966430664,93.55999755859375,92.37999725341797,92.37999725341797,1861700.0,-0.3300018310546875,0.3300018310546875,0.0,43.80156892584143,91.16000366210938,96.83999633789062,28.34498339798627,-71.65501660201373,0.012569576539135596,0.02377516059311046,-0.004720549787877282,323868100.0,-1.0
1240,ACGL,2025-02-05,93.05999755859375,93.13999938964844,92.22000122070312,92.97000122070312,1576800.0,0.29000091552734375,0.0,0.29000091552734375,46.17862870875957,91.16000366210938,96.83999633789062,33.450639902859415,-66.54936009714059,-0.031881261992495524,0.012643876075989262,0.00043002490830912343,325444900.0,1.0
1241,ACGL,2025-02-06,93.87999725341797,94.30000305175781,93.0,94.25,1367300.0,0.8199996948242188,0.0,0.8199996948242188,52.705285158457016,91.16000366210938,96.83999633789062,47.88727286403542,-52.11272713596459,-0.0009310172436443054,0.00992889741206255,0.012074116983553207,326812200.0,1.0
1242,ACGL,2025-02-07,93.5,94.06999969482422,93.16000366210938,93.8499984741211,1305000.0,-0.37999725341796875,0.37999725341796875,0.0,49.49591350940225,91.16000366210938,96.83000183105469,41.269790009930325,-58.73020999006967,-0.006984811319981077,0.006546155665653824,-0.03128881835993469,325507200.0,-1.0
1243,ACGL,2025-02-10,91.45999908447266,93.69000244140625,91.23999786376953,93.58999633789062,1982800.0,-2.0400009155273438,2.0400009155273438,0.0,35.939706727305236,91.16000366210938,96.83000183105469,5.290926265309253,-94.70907373469075,-0.17438332915610033,-0.02963974129869702,-0.03938661943135724,323524400.0,-1.0
1244,ACGL,2025-02-11,89.5999984741211,90.44000244140625,87.41999816894531,89.5,3121900.0,-1.8600006103515625,1.8600006103515625,0.0,27.900524983362203,87.41999816894531,96.83000183105469,23.166838010423323,-76.83316198957668,-0.45192485672916405,-0.11409676438479045,-0.04497976161191497,320402500.0,-1.0
1245,ACGL,2025-02-12,88.26000213623047,89.76000213623047,87.94000244140625,88.43000030517578,3316600.0,-1.339996337890625,1.339996337890625,0.0,23.52605995384225,87.41999816894531,96.83000183105469,8.926712437610874,-91.07328756238913,-0.7711160764346374,-0.24550062679475992,-0.06682173369073763,317085900.0,-1.0
1246,ACGL,2025-02-13,90.16000366210938,90.31999969482422,88.19000244140625,88.70999908447266,1728500.0,1.9000015258789062,0.0,1.9000015258789062,39.13800468587751,87.41999816894531,96.83000183105469,29.118006661326362,-70.88199333867364,-0.8608399464877721,-0.3685684907333624,-0.031266745914437455,318814400.0,1.0
1247,ACGL,2025-02-14,88.19999694824219,90.20999908447266,88.0199966430664,90.16000366210938,1824000.0,-1.9600067138671875,1.9600067138671875,0.0,31.486888440266625,87.41999816894531,96.83000183105469,8.289037999396784,-91.71096200060322,-1.077680095966258,-0.5103908117799416,-0.05263159619966007,316990400.0,-1.0
1248,ACGL,2025-02-18,88.33000183105469,88.9000015258789,87.76000213623047,88.68000030517578,1616300.0,0.1300048828125,0.0,0.1300048828125,32.496839291777746,87.41999816894531,95.16999816894531,11.74198273689516,-88.25801726310483,-1.2249170874305406,-0.6532960669100615,-0.04786024547456491,318606700.0,1.0
1249,ACGL,2025-02-19,88.69000244140625,89.31999969482422,88.05999755859375,88.4000015258789,1559200.0,0.3600006103515625,0.0,0.3600006103515625,35.533205195414936,87.41999816894531,95.05000305175781,16.64486841052716,-83.35513158947285,-1.2975965381801444,-0.7821561611640782,-0.04695889997671665,320165900.0,1.0
1250,ACGL,2025-02-20,89.05000305175781,89.3499984741211,87.77999877929688,88.51000213623047,2089300.0,0.3600006103515625,0.0,0.3600006103515625,38.714024563454814,87.41999816894531,94.61000061035156,22.67043573484096,-77.32956426515904,-1.3110337054553014,-0.887931670022323,-0.05144859760298204,322255200.0,1.0
1251,ACGL,2025-02-21,88.12999725341797,89.26000213623047,87.88999938964844,89.01000213623047,1724200.0,-0.9200057983398438,0.9200057983398438,0.0,33.79686224733183,87.41999816894531,94.30000305175781,10.319746810737922,-89.68025318926209,-1.3800116215019074,-0.9863476603182398,-0.05743318445542278,320531000.0,-1.0
1252,ACGL,2025-02-24,89.55000305175781,89.9800033569336,88.1500015258789,88.44000244140625,1386200.0,1.4200057983398438,0.0,1.4200057983398438,46.00953571665904,87.41999816894531,94.30000305175781,30.959351324497437,-69.04064867550255,-1.3050507043318191,-1.0500882691209559,-0.020883403147104462,321917200.0,1.0
1253,ACGL,2025-02-25,90.3499984741211,90.61000061035156,89.5,90.0,1652200.0,0.7999954223632812,0.0,0.7999954223632812,51.79061652853461,87.41999816894531,94.30000305175781,42.5871835134224,-57.4128164865776,-1.1676309696729277,-1.0735968092313504,0.008370535856835115,323569400.0,1.0
1254,ACGL,2025-02-26,89.56999969482422,90.6500015258789,89.12999725341797,90.2699966430664,1769400.0,-0.779998779296875,0.779998779296875,0.0,46.22259815923721,87.41999816894531,94.30000305175781,31.25,-68.75,-1.1088817244034885,-1.080653792265778,0.014842482742882135,321800000.0,-1.0
1255,ACGL,2025-02-27,92.0999984741211,92.36000061035156,89.79000091552734,90.0,2033600.0,2.529998779296875,0.0,2.529998779296875,61.65244341757603,87.41999816894531,94.06999969482422,70.37592829059153,-29.624071709408472,-0.8483930202239378,-1.03420163785741,0.021517244157200688,323833600.0,1.0
1256,ACGL,2025-02-28,92.91000366210938,94.2699966430664,91.81999969482422,92.9800033569336,2575500.0,0.8100051879882812,0.0,0.8100051879882812,65.32748681597312,87.41999816894531,94.2699966430664,80.1460834466605,-19.853916553339506,-0.5700223336314849,-0.9413657770122249,0.0534014385128736,326409100.0,1.0
